Foulmouthed = بذيء اللسان
Foulness = البذاءة
Fouls = الأخطاء
Found = وجد
Foundation = المؤسسة
Foundationer = المعال من قبل المؤسّسة
Foundationers = المعالون من قبل المؤسّسة
Foundations = المؤسسات
Founded = مؤسس
Founder = المؤسس
Foundered = مخفق
Foundering = الإخفاق
Founders = المؤسسون
Founding = التأسيس
Foundings = التأسيس
Foundling = اللقيط
Foundlings = اللقطاء
Foundress = المرأة المؤسسة
Foundries = المسابك
Foundry = المسبك
Founds = يؤسّس
Fount = الينبوع
Fountain = النافورة
Fountainhead = المنبع
Fountainheads = المنابع
Fountains = النافورات
Founts = الينابيع
Four = أربعة
Fourfold = أربعة أضعاف
Fourier = فوريير
Fours = الأربعات
Fourscore = الثمانون
Foursome = اللعبة الرباعية
Foursomes = الألعاب الرباعية
Foursquare = مربّع
Fourteen = أربعة عشر
Fourteenth = رابع عشر
Fourteenthly = بشكل رابع عشر
Fourth = الربع
Fourthly = رابعا
Fourths = الأرباع
Foutain = فوتين
Fovea = النّقرة
Foveae = النّقر
Foveal = بنقر
Foveate = منقّر
Fowl = الطير
Fowler = مرتكب الخطأ
Fowlers = صيادو الطيور
Fowling = الصيد
Fowlings = الصيد
Fowls = الطيور
Fox = الثّعلب
Foxed = مخدوع
Foxes = الثعالب
Foxglove = كفّ الثعلب
Foxgloves = قفّازات الثّعلب (أعشاب)
Foxhall = فوكسهال
Foxhole = جحر الثعالب
Foxholes = جحور الثعالب
Foxhound = كلب صيد الثعالب
Foxhounds = كلاب صيد الثعالب
Foxier = أشدّ مكرا
Foxiest = أشدّ مكرا
Foxiness = الجاذبية
Foxing = الخدع
Foxtail = ذيل الثعلب
Foxtails = ذيول الثعلب
Foxtrot = الفوكستروت (رقصة)
Foxy = ماكر
Foyer = الإستراحة
FPC = تركيز بروتين السّمك
Fracas = الشجار
Fracases = المشاجرات
Fractal = صورة النمطي هندسي متكرر
Fractals = صور النمطي هندسي متكرر
Fraction = الكسر
Fractional = جزئي
Fractionally = جزئيا
Fractionary = كسري
Fractionate = جزّئ
Fractionated = مجزّأ
Fractionation = التقطير
Fractionize = يجزّيء
Fractions = الكسور
Fractious = عنيد
Fractiously = بشكل عنيد
Fractiousness = المشاكسة
Fracture = الكسر
Fractured = مكسور
Fractures = الكسور
Fracturing = الكسر
Fragile = هشّ
Fragilely = بشكل هشّ
Fragileness = الهشاشة
Fragility = قابلية الكسر
Fragment = الجزء
Fragmental = متجزأ
Fragmentarily = بشكل متجزأ
Fragmentariness = الجزئية
Fragmentary = متجزأ
Fragmentation = التجزؤ
Fragmentations = التجزؤ
Fragmented = ممزّق
Fragmenting = التمزيق
Fragments = الأجزاء
Fragrance = العطر
Fragrances = العطور
Fragrancies = الروائح
Fragrancy = رائحي
Fragrant = معطّر
Fragrantly = بشكل معطّر
Frail = ضعيف
Frailer = أضعف
Frailest = أضعف
Frailly = بشكل ضعيف
Frailness = الضعف
Frailties = الضعف
Frailty = الضعف
Fraise = سلاح دفاعي
Fraises = أسلحة دفاعية
Frambesia = فرامبيسيا (مرض معدي)
Frame = الإطار
Frame-work = الإطار، الهيكل
Framed = مؤطّر
FrameFrameset = إطارمجموعة إطار
Framer = المبروز
Framers = المبروزون
Frames = الإطارات
Framework = الإطار، الهيكل
Frameworks = الهياكل
Framing = التأطير
Framings = البراويز
Fran = فران
Franc = الفرنك
Franca = فرانكا
France = فرنسا
Frances = فرانسيس
Francesca = فرانسيسكا
Francesco = فرانسيسكو
Franchise = الوكالة
Franchised = منح وكالة
Franchiser = صاحب الوكالة
Franchises = الوكالات
Franchising = منح وكالة
Francie = فرانسي
Francine = فرانسين
Francis = فرنسيس
Franciscan = الفرانسيسكاني
Franciscans = الفرانسيسكانيون
Francisco = فرانسيسكو
Francium = الفرنسيوم
Franco = فرانكو
Francois = فرانسوا
Francoise = فرانسيس
Francophobe = مبغض فرنسا
Francs = الفرنكات
Franctireur = فرانكتيرير
Frangibility = القابلية للكسر
Frangible = سهل الكسر
Frangipani = فرانجيباني (شجيرة)
Frank = فرانك
Franked = مدموغ
Frankel = فرانكل
Franker = أكثر صراحة
Frankest = أكثر صراحة
Frankford = فرانكفورد
Frankfort = فرانكفورت
Frankfurt = فرانكفورت
Frankfurter = سجقة فرانكفورتير
Frankfurters = سجق فرانكفورتير
Frankie = فرانكي
Frankincense = اللبان
Franking = الدمغ
Franklin = فرانكلين
Franklins = الفرانكلين
Frankly = بصراحة
Frankness = الصراحة
Franks = بريد خالي من الرسوم
Franny = فراني
Frantic = مسعور
Frantically = بشكل مسعور
Franticly = بشكل مسعور
Franticness = الغضب
Franz = فرانز
Frap = إربط
Frapped = مربوط
Frapping = الربط
Fraser = فريزر
Frat = نادي
Fraternal = أخوي
Fraternally = بشكل أخوي
Fraternities = النوادي
Fraternity = الأخوة
Fraternization = الإخاء
Fraternizations = الإخاء
Fraternize = تآخ
Fraternized = متآخى
Fraternizer = المنتسب للنادي
Fraternizers = المنتسبون للنادي
Fraternizes = يتآخي
Fraternizing = التآخي
Frates = فراتز
Fratricidal = قاتل الأخ
Fratricide = قتل الأخ
Fratricides = قتل الأخ
Frau = فرو
Fraud = الإحتيال
Frauds = الإحتيالات
Fraudulence = الإحتيال
Fraudulent = محتال
Fraudulently = بإحتيال
Fraudulentness = الإحتيال
Fraught = مشحون
Fraughted = شُحِن
Fraughting = الشحن
Fraughts = الشحنات
Fray = المشاجرة
Frayed = منهك
Fraying = الإبلاء
Frayne = فرين
Frays = يبلي
Frazier = فرايزر
Frazzle = أبل
Frazzled = مبلى
Frazzles = يبلي
Frazzling = الإبلاء
Freak = النزوة
Freakier = أكثر فظاعة
Freakiest = أكثر فظاعة
Freakiness = الغرابة
Freakish = فظيع
Freakishly = بشكل فظيع
Freakishness = الغرابة
Freaks = النزوات
Freaky = فظيع
Freckle = النمشة
Freckled = منمّش
Freckles = النمش
Freckling = التنميش
Fred = فريد
Freddie = فريدي
Freddy = فريدي
Frederic = فريدريك
Frederick = فريدريك
Fredericks = فريدريكس
Fredericksburg = فريدريكسبيرغ
Frederico = فريدريكو
Fredericton = فريدريكتون
Fredholm = فريدولم
Fredrick = فريدريك
Fredrickson = فريدريكسون
Free = حرّ
Free-lance = مستقلّ
Free-of-ground = الحرّة للأرض
Freebie = الهدية الترويجية
Freeboot = إسلب
Freebooter = القرصان
Freebooters = القراصنة
Freeborn = حرّ
Freed = محرّر
Freedman = المعتق
Freedmen = المعتقون
Freedom = الحرية
Freedoms = الحريات
Freehand = رسم حر
Freehanded = منفتح
Freehandedly = بشكل منفتح
Freehold = الملك الصرف
Freeholder = المالك الصرف
Freeholders = الملاك الصرف
Freeing = التحرير
Freelance = مستقلّ
Freeloader = المستغّل
Freeloaders = المستغّلون
Freely = بحرية
Freeman = فريمان
Freemason = الماسوني
Freemasonic = ماسوني
Freemasonry = الماسونية
Freemasons = الماسونيون
Freemen = الأحرار
Freeness = الحريّة
Freeport = فريبورت
Freer = أكثر حرية
Frees = يحرّر
Freest = أكثر حرية
Freestanding = طليق
Freestone = صخرة
Freestones = صخور
Freestyle = حرّ
Freethinker = المفكّر الحرّ
Freethinkers = المفكّرون الأحرار
Freethinking = التفكير الحرّ
Freethought = التفكير الحرّ
Freetown = فري تون
FreeVerb = فعل حر
Freeware = البرنامج المجّاني
Freeway = الطريق السريع
Freeways = الطرق السريعة
