Amp = الأمبير
Amperage = قوّة تيّار كهربائيّ
Amperages = قوّات تيّار كهربائيّ
Ampere = الأمبير
Amperes = الأمبيرات
Ampersand = الو
Ampersands = الوات
Ampex = أمبيكس
Amphetamine = المقوّي
Amphetamines = المقوّيات
Amphibian = الكائن البرمائيّ
Amphibians = الكائنات البرمائيّة
Amphibious = برمائيّ
Amphibiously = بشكل برمائي
Amphibiousness = البرمائيّة
Amphibole = الأمفيبولات
Amphibology = التباس
Amphioxys = حادّ الطرفين
Amphitheater = المدرّج
Amphitheaters = المدرّجات
Amphitheatre = المدرّج
Amphora = قارورة، جرّة
Amphorae = قوارير، جرّات
Ample = كافي، متّسع، وافي، مُسْهَبْ
Ampleness = السّعة
Ampler = أكثر كفاية
Amplest = الأكثر كفاية
Amplification = التّكبير
Amplifications = التّكبير
Amplified = أسهب
Amplifier = مكبّر الصّوت
Amplifiers = مكبّرات الصّوت
Amplifies = يسهب
Amplify = أسهب
Amplifying = الإسهاب
Amplitude = مدى التّردّد
Amplitudes = مدى التّردّد
Amply = بوفرة
Ampm = صم
Ampoule = الحقنة
Ampoules = الحقن
Amps = الأمبير
Amputate = ابتر
Amputated = بتر
Amputates = يبتر
Amputating = البتر
Amputation = البتر
Amputations = البتر
Amputee = المعوّق
Amra = أمرا
Ams = إيه إم إس
Amsterdam = أمستردام
Amtrak = شركه أمتراك
Amuck = باهتياج
Amulet = التّميمة
Amulets = التّمائم
Amuse = سلّ
Amused = مستمتع
Amusedly = بسعادة
Amusement = المتعة
Amusements = الملاهي
Amuser = مُسلّ
Amusers = مُسلّون
Amuses = يسلّي
Amusing = التّسلية
Amusingly = بطريقة مسلّية
Amusingness = التّسلية
Amusive = أمسايف
Amy = أمي
Amygdaloid = الصّخر البركانيّ
Amyl = أميلي
An = أداة تعريف
Ana = النّوادر
Anabaptist = قائل بتجديد عماد
Anabaptists = قائلون بتجديد عماد
Anabel = أنابل
Anachronism = الأثر
Anachronisms = الآثار
Anachronistic = منطوي على مفارقة تاريخيّة
Anachronistical = غير مناسب للعصر
Anachronistically = بصورة غير مناسبة للعصر
Anaconda = أفعى الأناكوندا
Anacondas = أفاعي الأناكوندا
Anadromous = الهجرة من الماء المالح للعذب لوضع البيض
Anaemia = الأنيميا
Anaerobic = لا هوائيّ
Anaesthesia = التّخدير
Anaglyph = النّقش
Anagram = الجناس النّاقص
Anagrams = الجناس النّاقصة
Anaheim = أناهييم
Anal = شرجيّ
Analeptic = مقوّي
Analgesia = فقدان الإحساس
Analgesic = المسكّن
Anally = شرجيًّا
Analog = النّظير
Analog-digital = النّظير رقميّ
Analog-to-digital = النّظير إلى رقميّ
Analogical = قياسيّ
Analogically = بشكل قياسي
Analogies = المقارنات
Analogous = متشابه
Analogously = بصورة متناظرة
Analogousness = التناظريّة
Analogs = النّظير
Analogue = النّظير
Analogy = المقارنة
Analyse = حلّل
Analyser = المحلّل
Analyses = التّحليلات
Analysis = التّحليل
Analyst = المحلّل
Analysts = المحلّلون
Analytic = تحليليّ
Analytical = تحليليّ
Analytically = بشكل تحليليّ
Analyticities = خواصّ تحليليّة
Analyticity = خاصّيّة تحليليّة
Analytics = التّحليل المنطقيّ
Analyzable = قابل للتّحليل
Analyze = حلّل
Analyzed = حلّل
Analyzer = المحلّل
Analyzers = المحلّلون
Analyzes = يحلّل
Analyzing = التّحليل
Anamorphic = صورة بصريّة مشوّهة
Anaphora = الجناس
Anaphoric = متعلّق بالجناس
Anaphorically = باستخدام الجناس
Anaplasmosis = أنابلازموسيس
Anarch = الفوضويّ
Anarchic = فوضويّ
Anarchical = فوضويّ
Anarchically = على نحو فوضويّ
Anarchies = الفوضويّ
Anarchist = الفوضويّ
Anarchistic = فوضويّ
Anarchists = الفوضويّون
Anarchy = الفوضويّة
Anarctica = أناركتيكا
Anastasia = أناستاسيا
Anastigmat = العدسة
Anastigmatic = مصحّح
Anastomoses = الوصلات
Anastomosis = التحام
Anastomotic = توصيلي
Anathema = اللّعنة
Anathematize = العن
Anathematized = لعن
Anathematizes = يلعن
Anathematizing = اللّعن
Anatole = أناتول
Anatomic = تشريحيّ
Anatomical = تشريحيّ
Anatomically = تشريحيًّا
Anatomicals = تشريحيّات
Anatomies = البنى
Anatomist = عالم التّشريح
Anatomize = شرّح
Anatomized = شرّح
Anatomizes = يشرّح
Anatomizing = التّشريح
Anatomy = التّشريح
Ancestor = الجدّ
Ancestors = الأجداد
Ancestory = الجدوديّة
Ancestral = سلفيّ
Ancestrally = بشكل سلالي
Ancestress = السّلف
Ancestresses = الأسلاف
Ancestries = الأصول
Ancestry = الأصل
Anchor = المرساة
Anchorage = أنكريج
Anchorages = المراسي
Anchored = رسا
Anchoring = الرّسو
Anchorite = النّاسك
Anchoretism = حياة العزلة
Anchors = المراسٍ
Anchovies = الأنشوفة
Anchovy = الأنشوفة
Ancient = قديم
Anciently = قديمًا
Ancientness = القدم
Ancients = القدماء
Ancillaries = المساعدون
Ancillary = مساعد
And = و
Andean = إنديزي
Anded = جمع منطقيّا، استخدام المعامل & مع المتغيّرات
Anders = أندرس
Andersen = أندرسن
Anderson = أندرسون
Andes = أنديز
Andesine = أنديساين
Andesite = أنديسايت
Anding = جمع منطقيّا، استخدام المعامل & مع المتغيّرات
Andiron = المسند
Andorra = أندورا
Andover = أندوفر
Andre = أندريه
Andrea = أندريه
Andrei = أندريي
Andrew = أندرو
Andrews = أندروز
Androgenic = منشّط الذّكورة
Androgens = منشّطات الذّكورة
Androgynous = مخنّث
Android = الرّوبوت
Andromache = أندروماش
Andromeda = آندروميدا
Ands = يستخدم المعامل AND
Andy = أندي
Anecdotal = قصصيّ
Anecdotally = بصورة قصصيّة
Anecdote = النّادرة
Anecdotes = النّادرات
Anecdotic = قصصي
Anecdotist = القاصّ
Anecdotists = القصّاصون
Anechoic = لا صدويّ، لا يحتوي أو ينتج عنه صدى
Anemia = الأنيميا
Anemias = الأنيميا
Anemic = مصاب الأنيميا
Anemically = بصورة أنيمية
Anemics = مصابوا الأنيميا
Anemometer = مقياس شدّة الرّيح
Anemometers = مقاييس شدّة الرّيح
Anemometry = قياس شدّة ريح
Anemone = الانيمن
Anemones = الانيمن
Anent = عن
Anesthesia = التّخدير
Anesthesias = التّخدير
Anesthesiologist = طبيب التّخدير
Anesthesiology = مبحث التّخدير
Anesthetic = المخدّر
Anesthetically = بالتّخدير
Anesthetics = المخدّرات
Anesthetist = إخصائيّ التّخدير
Anesthetists = إخصائيّون التّخدير
Anesthetization = التّخدير
Anesthetize = خدّر
Anesthetized = خدّر
Anesthetizer = مختصّ التخدير
Anesthetizers = مختصّوا التخدير
Anesthetizes = يخدّر
Anesthetizing = التّخدير
Anew = من جديد
Angel = الملاك
Angela = أنجيلا
Angeleno = أنجيلينو
Angelenos = أنجيلينوس
Angeles = أنجيليز
Angelfish = السّمك
Angelic = ملائكيّ
Angelica = الأنجليك
Angelical = ملائكيّ
Angelically = بملائكيّة
Angelina = أنجيلينا
Angeline = أنجيلاين
Angelo = أنجلو
Angels = الملائكة
Anger = الغضب
Angered = أغضب
Angering = الإغضاب
Angers = الغضب
Angie = أنجي
Angiography = تصوير تتبعي بالأشعة السينية
Angiosperm = نبات ملقّح ذاتيًّا
Angle = الزّاوية
Angled = مزّوىّ
Angler = الصّيّاد
Anglers = الصّيّادون
Angles = الزّوايا
Anglia = أنجليا
Anglican = الأنجليكي
Anglicanism = الأنجليكية
Anglicans = الأنجليكي
Angling = الصّيد
Anglo = الأمريكيّ
Anglophilia = الحبّ الإنجليزيّة
Anglophobia = الكراهية الإنجليزيّة
Angola = أنجولا
Angora = الأنجورا
Angrier = أكثر غضبًا
Angriest = الأكثر غضبًا
Angrily = بغضب
Angriness = الغضب
Angry = غاضب
Angst = القلق
Angstrom = أنجستروم
Angstroms = أنجسترومز
Anguilla = أنجولا
Anguish = العذاب
Anguished = تألّم
Anguishes = العذابات
