Harpsichordist = عازف هاربسيكورد
Harpsichords = البيان
Harpy = الطمّاع
Harried = مغزو
Harrier = هارير
Harries = يغزو
Harriet = هاريت
Harriman = هاريمان
Harrington = هارينجتون
Harris = هاريس
Harrisburg = هاريسبيرغ
Harrison = هاريسن
Harrisonburg = هاريسونبيرغ
Harrow = المشط
Harrowed = مسلوب
Harrower = الزّاحف
Harrowing = السلب
Harrowingly = بشكل فظيع
Harrows = الأمشاط
Harrumph = يتنحنح
Harrumphed = تنحنح
Harrumphing = التنحنح
Harry = هيري
Harrying = الغزو
Harsh = قاسي
Harshen = يصعّب
Harshened = صعَّب
Harshening = التصعيب
Harsher = أقسى
Harshest = أقسى
Harshly = بقسوة
Harshness = القسوة
Hart = هارت
Hartford = هارتفورد
Hartley = هارتلي
Hartman = هارتمان
Harts = الوعول
Harvard = هارفارد
Harvest = الحصاد
Harvested = محصود
Harvester = الحاصدة
Harvesters = الحاصدات
Harvesting = الحصاد
Harvestman = الحاصد
Harvestmen = الحاصدون
Harvests = يحصد
Harvey = هارفي
Has = له
Hash = اللحم المهروس
Hashed = مثروم
Hasher = هاشير
Hashes = علامات الرقم
Hashing = الثرم
Hashish = الحشيش
Haskell = حزقيل
Haskins = هاسكينز
Hasp = الربّاط
Hasps = الربّاطات
Hass = هاس
Hassle = الإزعاج
Hassled = منزعج
Hassler = هاسلر
Hassles = الإزعاج
Hassling = الإزعاج
Hassock = الوسادة
Hast = يمتلك
Haste = الإستعجال
Hasted = معجّل
Hasten = عجّل
Hastened = معجّل
Hastener = المُسرع
Hastening = التعجيل
Hastens = يعجّل
Hastes = الإستعجالات
Hastier = مستعجل
Hastiest = مستعجل
Hastily = بعجالة
Hastiness = العجلة
Hasting = التعجيل
Hastings = هاستينجز
Hasty = مستعجل
Hat = القبعة
Hatband = رباط البرنيطة
Hatbands = أربطة البرنيطة
Hatch = الفتحة
Hatched = مفقّس
Hatcher = الفقّاس
Hatcheries = المفاقس
Hatchery = المفقس
Hatches = الفتحات
Hatchet = الفأس
Hatchets = الفؤوس
Hatching = التفقيس
Hatchure = الرّقن
Hatchway = الفتحة
Hate = الحقد
Hated = مكروه
Hateful = حقود
Hatefully = بشكل حقود
Hatefulness = الكراهية
Hater = المعادي
Hates = يكره
Hatfield = هاتفيلد
Hath = هاث
Hathaway = هاثاواي
Hating = الكراهية
Hatless = بلا قبّعة
Hatred = الكراهية
Hats = القبعات
Hatted = هاتيد
Hatteras = هاتيراس
Hatters = صناع القبعات
Hattie = هاتي
Hattiesburg = هاتيسبيرغ
Haugen = هاوجين
Haughtier = متغطرس
Haughtiest = متغطرس
Haughtily = بغطرسة
Haughtiness = الغطرسة
Haughty = متغطرس
Haul = العتلة
Haulage = النقل
Hauled = مسحوب
Hauler = متعهد النقل
Haulers = متعهدو النقل
Hauling = السحب
Hauls = العتلات
Haunch = الورك
Haunched = بأفخاذ
Haunches = الورك
Haunt = المزار
Haunted = مطارد
Haunter = الزّائر
Haunters = الزّوّار
Haunting = المطاردة
Hauntingly = حزنا
Haunts = المزارات
Haupt = هوبت
Hausdorff = هوسدورف
Hauser = هوسير
Hauteur = الإستكبار
Havana = هافانا
Have = له
Haven = الملجأ
Havens = الملاجئ
Haver = ثرثر
Havering = هافيرينج
Havers = يثرثر
Haversack = الجراب
Haves = الموسرون
Having = الإمتلاك
Havoc = الخراب
Havocs = الخراب
Haw = الزعرورة
Hawaii = هاواي
Hawaiian = هاواي
Hawing = التلعثم
Hawk = الصقر
Hawked = إصطاد عن طريق الصقر
Hawker = البائع المتجول
Hawkers = الباعة المتجولون
Hawking = الصيد عن طريق الصقر
Hawkins = هوكينز
Hawkish = متشدّد
Hawkishly = بشكل متشدّد
Hawks = الصقور
Hawley = هاولي
Haws = الزعرور
Hawser = الحبل
Hawsers = الحبال
Hawthorn = الزعرور
Hawthorne = هاوثورن
Hawthorns = الزعرور
Hay = القشّ
Hay fever = حمّى القشّ
Haycock = هايكوك
Haycocks = أكوام القشّ
Hayden = هايدن
Haydn = هايدن
Hayer = هاير
Hayes = هايز
Hayfield = حقل القش
Haying = قطع الحشائش
Hayloft = مخزن التّبن
Haylofts = مخازن التّبن
Haynes = هاينيس
Hays = القشّ
Haystack = كومة التبن
Haystacks = أكوام التبن
Hayward = هايوارد
Haywire = مجنون
Haywood = هايوود
Hazard = الخطر
Hazarded = مخاطر ب
Hazarding = المخاطرة
Hazardous = خطر
Hazardously = بشكل خطر
Hazardousness = الخطورة
Hazards = الأخطار
Haze = السديم
Hazed = مشوّش
Hazel = هيزل
Hazelnut = البندقة
Hazelnuts = البندق
Hazels = البندق
Hazer = هازير
Hazes = يشوّش
Hazier = أكثر إكفهرارا
Haziest = أكثر إكفهرارا
Hazily = بشكل مكفهر
Haziness = التشوش
Hazing = التشويش
Hazy = خافت
He = هو
Head = الرئيس
Head-clerk = رئيس كاتب
Headache = الصداع
Headaches = الصداع
Headband = العصابة
Headbands = العصابات
Headboard = اللّوح الأماميّ
Headboards = الألواح الأماميّة
Headcheese = نقانق من لحم الرأس
Headcheeses = نقانق من لحم الرأس
Headdress = غطاء الرأس
Headed = برأس
Header = العنوان الرأسي
HeaderFooter = رأستذييل
Headers = العناوين الرأسية
Headgear = غطاء الرأس
Headier = أكثر إندفاعا
Headiest = أكثر إندفاعا
Headily = بشكل مندفع
Headiness = السّكر
Heading = العنوان
Headings = العناوين
Headland = الرأس البحري
Headlands = الرؤوس البحرية
Headless = بلا رأس
Headlessness = بلارأس
Headlight = الضوء العلوي
Headlights = الأضواء العلوية
Headline = العنوان البارز
Headlined = تحت عنوان
Headliner = المتصدر عناوين
Headlines = العناوين البارزة
Headlining = العنونة
Headlong = متهور
Headman = الزّعيم
Headmaster = المدير
Headmasters = المدراء
Headmistress = المديرة
Headmistresses = المديرات
Headmost = أوّل
Headphone = السماعة
Headphones = السماعات
Headpiece = غطاء الرأس
Headpieces = أغطية الرأس
Headquarter = إتّخذ مقرا
Headquartered = إتّخذ مقرا
Headquarters = المقر
Headrest = المخدّة
Headrests = المخدّات
Headroom = الإرتفاع
Heads = الرؤوس
Headsail = الشراع الأمامي
Headset = السماعة
Headsets = السماعات
Headship = الرّئاسة
Headsman = سياف
Headsmen = السيافون
Headstand = الوقفة على اليدين
Headstands = الوقفات على اليدين
Headstone = شاهد القبر
Headstones = شواهد القبور
Headstrong = متهور
Headwaiter = كبير الخدم
Headwaiters = كبار الخدم
Headwater = المنبع
Headwaters = المنابع
Headway = التقدّم
Headwind = الرّياح العكسيّة
Headwinds = الرّياح المضادّة في الإتجاه
Headword = مدخل في المعجم
Heady = مندفع
Heal = أشف
Healable = قابل للإشفاء
Healed = مشفى
Healer = المعالج
Healers = المعالجون
Healey = هيلي
Healing = الشفاء
Heals = يشفي
Health = الصحة
Healthful = صحّي
Healthfully = بشكل صحّي
Healthfulness = الصحّيةّ
Healthier = أصح
Healthiest = أصح
Healthily = بشكل صحي
