Angular = بارز العظام
Angularity = خاصّيّة وجود زوايا
Angularly = زاويا
Angularness = كمّ خاصية وجود زاويا
Angus = أنجس
Anharmonic = غير متناغم
Anheuser = أنهيسر
Anhydride = الأندريد
Anhydrite = الأنهيدريت
Anhydrous = جافّ
Anhydrously = بشكل لامائي
Ani = أني
Aniline = الأنيلين
Animadversion = الملاحظة الانتقاديّة
Animadversions = الملاحظات الانتقاديّة
Animadvert = انتقد
Animadverted = انتقد
Animadverts = ينتقد
Animal = الحيوان
Animalcule = الحيوان الصّغير
Animalcules = الحيوانات الصّغيرة
Animalism = الحيوانيّة
Animalistic = حيوانيّ
Animality = السّمات الحيوانيّة
Animally = جسديًّا
Animalness = كمّ السّمات الحيوانيّة
Animals = الحيوانات
Animate = حيّ
Animated = متحمّس
Animatedly = بحماس
Animately = بشكل متحرّك
Animateness = الحركيّة
Animates = ينعش
Animating = الإنعاش
Animation = الرّسوم المتحرّكة
Animations = الرّسوم المتحرّكة
Animator = إخصائيّ رسوم متحرّكة
Animators = إخصائيّون رسوم متحرّكة
Anime = انيما
Animism = الرّوحانيّة
Animize = يعطي خواصّ الحياة
Animized = أعطى خواصّ الحياة
Animosity = الكراهية
Animus = الكراهية
Anion = الأنيون
Anionic = أنيونيّ
Anionics = أنيونيّات
Anions = الأنيون
Anise = الينسون
Aniseed = اليانسون
Anisotropic = متباين الخواصّ
Anisotropies = تباينات الخواصّ
Anisotropy = تباين الخواصّ
Anita = أنيتا
Ankara = أنقرة
Ankle = الكاحل
Anklebone = عظم الكاحل
Ankles = الكواحل
Anklet = الخلخال
Anlog = لا سجلّي
Ann = الشّبكة العربيّة الإخباريّة
Anna = الآنة
Annal = أنال
Annale = أنيل
Annalen = أنالين
Annalist = المؤرّخ
Annals = السّجلّات
Annapolis = أنابوليس
Anne = أن
Anneal = يصلّب
Annealed = صلَّب
Annealer = مصلِّب
Annealers = مصلّبون
Annealing = الصلّب
Anneals = صلّب
Annelids = الدّيدان الحلقيّة
Annette = أنات
Annex = الملحق
Annexation = الضّمّ
Annexations = الضّمّ
Annexed = استولى
Annexes = الملاحق
Annexing = الاستيلاء
Annie = أني
Annihilate = اهلك
Annihilated = أهلك
Annihilates = يهلك
Annihilating = الإهلاك
Annihilation = الإبادة
Annihilative = مدمّر
Annihilator = المدمّر
Anniversaries = الأعياد
Anniversary = العيد
Annotate = علّق
Annotated = علّق
Annotates = يعلّق
Annotating = التّعليق
Annotation = التّعليق
Annotations = التّعليقات
Annotative = تعليقيّ
Annotator = معلّق الحواشي
Announce = أعلن
Announced = أعلن
Announcement = الإعلان
Announcements = الإعلانات
Announcer = المذيع
Announcers = المذيعون
Announces = يعلن
Announcing = الإعلان
Annoy = ضايق
Annoyance = الضّيق
Annoyances = مصادر الإزعاج
Annoyed = متضايق
Annoyer = مزعج
Annoyers = مزعجون
Annoying = مزعج
Annoyingly = بشكل مزعج
Annoys = يضايق
Annual = النّبات الحوليّ
Annualized = محسوب سنويًّا
Annually = سنويًّا
Annuals = النّباتات الحوليّة
Annuitant = السناهي
Annuities = المعاشات
Annuity = المعاش
Annul = يبطل
Annular = حلقيّ
Annularly = حلقيا
Annuler = مبطل
Annuli = الأعمدة الحلقية
Annullable = قابل للإبطال
Annulled = أُبْطِل
Annulling = إبطال
Annulment = الإبطال
Annulments = الإبطالات
Annuls = يُبطل
Annulus = الحلقة
Annum = العام
Annunciate = أعلن
Annunciated = أعلن
Annunciates = يعلن
Annunciating = الإعلان
Annunciation = بشارة جبريل
Annunciations = بشائر جبريل
Annunciator = المذيع
Annunciators = المذيعون
Anode = قطب الموجب
Anodes = أقطاب الموجب
Anodic = أنوديك
Anodically = متعلقا بالقطب الموجب
Anodize = اطل بأكسيد الألومنيوم
Anodized = طلى بأكسيد الألومنيوم
Anodizes = يطلي بأكسيد الألومنيوم
Anodizing = طلاء بأكسيد الألومنيوم
Anoint = ادهن
Anointed = دهن
Anointer = مُدهِن
Anointing = الدّهن
Anointment = المسح
Anoints = يدهن
Anomalies = العيوب
Anomalistic = غير قياسيّ
Anomalous = شاذّ
Anomalously = بصورة شاذّة
Anomalousness = الشذوذ
Anomalousnesses = الشذوذ
Anomaly = الشواذّ
Anomic = ذو شواذّ
Anomie = غير أخلاقي اجتماعيّاً
Anon = حالاً
Anonymities = إخفاء الهويّة
Anonymity = إخفاء الهويّة
Anonymous = مجهول الاسم
Anonymously = بدون اسم
Anonymousness = اللاهويّة
Anorak = المعطف واقٍ
Anorexia = الفقدان الشّهيّة
Anorthic = ذي محاور منحرفة
Anorthite = أنورثيت
Anorthosite = أنورثوسيت
Another = آخر
Ans = أنز
Anselm = أنسيلم
Anselmo = أنسيلمو
Anson = أنسون
Answer = الإجابة
Answerable = مسئول
Answerback = ردّ على بثّ لاسلكي
Answered = ردّ
Answerer = مجاوب
Answerers = مجاوبون
Answering = الرّدّ
Answers = الإجابات
Ant = النّملة
Antacid = مضادّ للحموضة
Antaeus = أنتايِس
Antagonism = العداء
Antagonisms = العداءات
Antagonist = الخصم
Antagonistic = عدوانيّ
Antagonistical = عدوانيّ
Antagonistically = بعدوانيّة
Antagonists = الخصوم
Antagonize = عادِ
Antagonized = عادَى
Antagonizer = معادي
Antagonizers = معادون
Antagonizes = يعادي
Antagonizing = العداوة
Antarctic = القطب الجنوبيّ
Antarctica = القارة القطبية الجنوبية
Antares = قلب العقرب
Ante = ادفع
Anteater = آكل النّمل
Anteaters = أكلة النّمل
Antebellum = ما قبل الحرب
Antecede = اسبق
Anteceded = سبق
Antecedence = الأسبقيّة
Antecedent = الأوّل
Antecedently = بشكل سابق
Antecedents = الأوّل
Antecedes = يسبق
Anteceding = السّبق
Antechamber = الملحق
Anted = دفع
Antedate = اسبق
Antedated = سبق
Antedates = يسبق
Antedating = السّبق
Antediluvian = عتيق
Anteing = الدّفع
Antelope = الظّبي
Antelopes = الظّباء
Antenna = القرن
Antennae = الهوائيات
Antennas = القرون
Anterior = أماميّ
Anteriorly = بشكل سابق
Anteriors = الأجزاء الأمامية
Anteroom = حجرة الانتظار
Anterooms = حجرات الانتظار
Antes = يدفع
Anthem = النّشيد
Anthems = الأناشيد
Anther = العضو الذّكريّ
Anthill = عشّ النّمل
Anthologies = المقتطفات الأدبيّة
Anthologist = الباحث
Anthology = المقتطفات الأدبيّة
Anthony = أنتوني
Anthracene = أنثراسين
Anthracite = أنثراسايت
Anthracnose = أنثراكنوز - مرض اصفرار النبات
Anthropogenic = دراسة أصل الأحياء
Anthropoid = إنسان الغابة
Anthropological = أنثربولوجيّ
Anthropologically = أنثروبولوجيًّا
Anthropologies = الأنثربولوجيا
Anthropologist = عالم الأنثروبولوجيا
Anthropologists = علماء الأنثروبولوجيا
Anthropology = الأنثربولوجيا
Anthropometric = متعلّق بالأنثروبومتريّة
Anthropometrics = علم قياسات الجسم البشري
Anthropometry = الأنثروبومتريّة
Anthropomorphic = مجسّم
Anthropomorphically = باستخدام المجسّمات
Anthropomorphism = الآدميّة
Anti = مضادّ
Anti-Alias = مضادّ للاسم المستعار
Anti-Aliasing = مضادّ للألياسينج
Anti-alien = مضادّ للأجنبيّ
Anti-demonstration = مضادّ للمظاهرة
Antiaircraft = مضادّ للطّائرات
Antialias = تحسين الحواف
Antialiased = الحواف المحسّنة
Antialiasing = تحسين الحواف
Antibacterial = مضادّ للبكتيريا
Antibiotic = المضادّ الحيويّ
Antibiotics = المضادّات الحيويّة
Antibodies = الأجسام المضادّة
Antibody = الجسم المضادّ
Antibusiness = مضادّ للعمل
Antic = غريب
Antichrists = المسيحون الدّجّال
Anticipate = توقّع
Anticipated = توقّع
Anticipates = يتوقّع
Anticipating = التّوقّع
Anticipation = التّوقّع
Anticipations = التّوقّعات
Anticipative = متوقّع
Anticipatively = بشكل تطلعي
Anticipator = المتوقّع
Anticipatory = متوقّع
Anticlerical = ضدّ سيطرة القساوسة
Anticlimactic = منحدر
Anticlimactically = بانحدار
Anticlimaxes = الصّدمات
Anticoagulation = منع تخثّر الدّم
