Immoderately = بشكل مفرط
Immoderateness = التطرّف
Immoderation = التطرّف
Immodest = دعيّ
Immodestly = بشكل دعيّ
Immodesty = التكبّر
Immolate = ضحّ به
Immolated = مضحّى ب
Immolates = يضحّي به
Immolating = التضحية
Immolation = التضحية
Immoral = عديم الأخلاق
Immoralities = الانحرافات
Immorality = العهر
Immorally = بشكل عديم الأخلاق
Immortal = خالد
Immortality = الخلود
Immortalize = خلّد
Immortalized = مخلّد
Immortalizes = يخلّد
Immortalizing = التخليد
Immortally = بشكل خالد
Immortals = الخالدون
Immovability = الرسوخ
Immovable = ثابت
Immovableness = الرسوخ
Immovables = الثوابت
Immovably = بلا حركة
Immun = إمان
Immune = منيع
Immunities = المناعات
Immunity = المناعة
Immunization = التلقيح
Immunizations = التلقيح
Immunize = لقّح
Immunized = لقّح
Immunoelectrophoresis = انفصال و تعريف البروتينات
Immunological = مناعي
Immunologically = مناعيا
Immunology = علم المناعة
Immured = محصور
Immutability = الثبات
Immutable = ثابت
Immutableness = الثبات
Immutably = بثبات
Imp = العفريت
Impact = التأثير
Impacted = مغمور
Impacter = إمباكتر
Impacting = التأثير على
Impaction = الإنحشار
Impactions = الإنحشار
Impactive = ناتج عن التّصادم
Impactor = المتصادم
Impacts = التأثيرات
Impair = أضعف
Impaired = ضعيف
Impairer = المفسد
Impairing = الإضعاف
Impairment = الضعف
Impairments = الضعف
Impairs = يضعف
Impale = خوزق
Impaled = مخوزق
Impalement = التطويق
Impalements = التطويق
Impales = يخوزق
Impaling = التخوزق
Impalpable = غير محسوس
Impalpably = بصورة غير ملموسة
Imparity = التباين
Impart = إمنح
Impartation = الإفساد
Impartations = الإفسادات
Imparted = ممنوح
Impartial = نزيه
Impartiality = النزاهة
Impartially = بشكل نزيه
Impartialness = الحيادية
Imparting = المنح
Imparts = يمنح
Impassable = غير قابل للعبور
Impassableness = إستحالة العبور
Impassably = بصورة غير سالكة
Impasse = الطريق المسدود
Impasses = الطرق المسدودة
Impassibility = عدم الشعور
Impassible = عديم الشعور
Impassibly = متعلق بعديم الحسّ
Impassion = أثر
Impassioned = حماسي
Impassioning = الإثارة
Impassions = يثير
Impassive = غير منفعل
Impassively = بشكل غير منفعل
Impassiveness = عدم الشعور
Impassivity = عدم الشعور
Impatience = نفاد الصبر
Impatient = غير صبور
Impatiently = بنفاذ صبر
Impeach = إتّهم
Impeachable = قابل للإتهام
Impeached = متّهم
Impeaches = يتّهم
Impeaching = الإتّهام
Impeachment = المعاقبة
Impeccability = غاية الإتقان
Impeccable = معصوم
Impeccably = بشكل منزّه
Impecunious = معدم
Impecuniously = بشكل معدم
Impecuniousness = الإفلاس
Impedance = المعاوقة الكهربائية
Impedances = المعاوقات الكهربائية
Impede = عرقل
Impeded = معرقل
Impeder = إمبيدر
Impedes = يعرقل
Impediment = العائق
Impediments = العوائق
Impeding = العرقلة
Impel = إدفع
Impelled = مدفوع
Impellent = الدافع
Impeller = الدفاعة
Impellers = الدفاعات
Impelling = الدفع
Impels = يدفع
Impend = هدّد
Impended = مهدّد
Impending = التهديد
Impends = يهدّد
Impenetrability = المناعة
Impenetrable = منيع
Impenetrableness = المناعة
Impenetrably = بمناعة
Impenitence = التمادي
Impenitent = غير نادم
Impenitently = بشكل غير نادم
Imperate = يفرض
Imperative = الأولوية
Imperatively = حتميا
Imperativeness = الضّرورة
Imperatives = الأولويات
Imperceivable = غير واضح
Imperceptible = لايدرك
Imperceptibly = بشكل غير ملحوظ
Imperceptive = لاإدراكي
Imperfect = ناقص
Imperfectability = عدم القدرة على الكمال
Imperfection = النقص
Imperfections = النقائص
Imperfective = عدم مراعاة للبداية أو انتهاء العمل للفعل
Imperfectly = بشكل ناقص
Imperfectness = النقص
Imperfects = الأفعال الماضية النّاقصة
Imperforate = غير مثقّب
Imperial = الإمبراطور
Imperialism = الإمبريالية
Imperialisms = الإمبريالية
Imperialist = الإمبريالي
Imperialistic = إستعماري
Imperialistically = بطريقة إمبرياليّة
Imperialists = الإمبرياليون
Imperially = بشكل إمبراطوري
Imperil = خاطر
Imperiled = عرّض للخطر
Imperiling = التعريض للخطر
Imperils = يخاطر
Imperious = متجبّر
Imperiously = بشكل متجبّر
Imperiousness = الجبريّة
Imperishability = الخلود
Imperishable = خالد
Imperishableness = الخلود
Imperishably = بطريقة خالدة
Impermanence = المؤقتية
Impermanent = مؤقت
Impermanently = بشكل مؤقت
Impermeability = عدم النفاذ
Impermeable = غير نفّاذ
Impermeableness = عدم النفاذ
Impermeably = بصورة عازلة
Impermissible = محظور
Impersonal = غير شخصي
Impersonalized = معمّم
Impersonally = موضوعيا
Impersonate = قلّد
Impersonated = مقلّد
Impersonates = يقلّد
Impersonating = التقليد
Impersonation = التقليد
Impersonations = التقليد
Impersonator = المقلد
Impertinence = الصلافة
Impertinences = الصلافة
Impertinent = صلف
Impertinently = بوقاحة
Imperturbability = الهدوء
Imperturbable = هادئ
Imperturbableness = التماسك
Imperturbably = بثبات
Impervious = غير نفّاذ
Imperviously = بشكل غير نفّاذ
Imperviousness = عدم النفاذ
Impetigo = الحصف
Impetuous = متهور
Impetuously = بشكل متهور
Impetuousness = التهور
Impetus = الحافز
Impetuses = الحوافز
Impiety = المعصية
Impinge = إرتطم
Impinged = مرتطم
Impingement = الإصطدام
Impingements = الإصطدامات
Impinges = يرتطم
Impinging = الإرتطام
Impious = أثيم
Impiously = بشكل أثيم
Impiousness = العقوق
Impish = عفريتي
Impishly = بشكل عفريتي
Impishness = الشّيطانيّة
Implacability = الحقد
Implacable = متصلّب
Implacableness = الحقد
Implacably = بتصلب
Implant = الزرع
Implantation = الزرع
Implantations = الزرع
Implanted = مزروع
Implanter = القائم بعمليّة الغرس
Implanting = الزراعة
Implants = يزرع
Implausibility = اللامعقولية
Implausible = غير قابل للتّصديق
Implausibleness = اللامعقولية
Implausibly = بشكل لا يصدّق
Implement = الأداة
Implementation = التطبيق
Implementations = التطبيقات
Implemented = مطبّق
Implementer = المطبّق
Implementers = المطبّقون
Implementing = التطبيق
Implementor = المطبّق
Implementors = المطبّقون
Implements = الأدوات
Implicate = ورّط
Implicated = مورّط
Implicates = يورّط
Implicating = التوريط
Implication = النتيجة
Implications = النتائج
Implicative = توريطي
Implicatively = مائلا للتوريط
Implicativeness = التضمينيّة
Implicatory = تضمينيّ
Implicit = ضمني
Implicitly = ضمنيا
Implicitness = الضمنيةّ
Implied = ضمني
Implies = يدلّ عليه
Implode = إنفجر
Implore = ناشد
Implored = مناشد
Implores = يناشد
Imploring = المناشدة
Imploringly = بتوسل
Implosion = الإنهيار الداخلي
Implosive = إمبلوسيف
Imply = دلّ عليه
Implying = الدلالة على
Impolite = وقح
Impolitely = بشكل وقح
Impoliteness = الوقاحة
Impolitic = غير حكيم
Impolitically = لاسياسياً
Impoliticly = بشكل غير حكيم
Impoliticness = ألاسياسية
Imponderability = عدم القدرة على التقييم
Imponderable = مستحيل التقدير
Imponderableness = أستحالة التقدير
Imponderables = الأمور المجهولة
Imponderably = باستحالة التقدير
Import = الإستيراد
Importable = قابل للإستيراد
Importance = الأهمية
Important = مهم
Importantly = بأهمية
Importation = الإستيراد
Importations = الإستيراد
Imported = مستورد
Importer = المستورد
Importers = المستوردون
Importing = الإستيراد
Imports = الإستيرادات
Importunate = ملح
Importunately = بإلحاح
