Importunateness = الإزعاج
Importune = ملح
Importunely = بشكل ملح
Importuner = المزعج
Importuners = المزعجون
Importuning = اللجّ
Importunities = الإلحاح
Importunity = الإلحاح
Impose = إفرض
Imposed = مفروض
Imposer = الفارض
Imposes = يفرض
Imposing = الفرض
Imposingly = بشكل بارز
Imposition = الفرض
Impositions = الفروض
Impossibilities = الإستحالات
Impossibility = الإستحالة
Impossible = مستحيل
Impossibleness = الإستحالة
Impossibly = مستحيلا
Impost = المكس
Imposter = النّصّاب
Impostor = المنتحل
Impostors = المنتحلون
Imposts = المكوس
Imposture = الخدعة
Impostures = الخدع
Impotence = العجز
Impotency = العجز
Impotent = عاجز
Impotently = بشكل عقيم
Impound = إحجز
Impounded = محجوز
Impounding = الحجز
Impoundment = الحجز
Impoundments = الحجوزات
Impounds = يحجز
Impoverish = أفقر
Impoverished = فقير
Impoverisher = المفقّر
Impoverishes = يفقر
Impoverishing = الإفقار
Impoverishment = التفقير
Impracticability = اللا عملية
Impracticable = غير واقعي
Impracticableness = اللا عملية
Impractical = غير عملي
Impracticality = اللا عملية
Impractically = بشكل غير عملي
Impracticalness = اللا عملية
Imprecate = إلعن
Imprecated = ملعون
Imprecates = يلعن
Imprecating = اللعنة
Imprecation = اللعنة
Imprecations = اللعنات
Imprecatory = لاعن
Imprecise = غير دقيق
Imprecisely = بشكل غير دقيق
Impreciseness = عدم الدقّة
Imprecision = الغموض
Impregnable = حصين
Impregnableness = المناعة
Impregnably = بمناعة
Impregnate = ملقّح
Impregnated = ملقّح
Impregnates = يلقّح
Impregnating = التلقيح
Impregnation = الإشباع
Impregnations = الإشباع
Impresario = متعهد الحفلات
Impress = الختم
Impressed = معجب
Impresser = إمبريسير
Impresses = الأختام
Impressible = حساس
Impressibly = بليونة
Impressing = إثارة إعجاب
Impression = الإنطباع
Impressionable = قابل للتحوير
Impressionableness = الحساسية
Impressionism = الإنطباعية
Impressionist = الإنطباعي
Impressionistic = إنطباعي
Impressionists = الإنطباعيون
Impressions = الإنطباعات
Impressive = رائع
Impressively = بشكل مثير للإعجاب
Impressiveness = الإثارة
Impressment = التّجنيد
Imprimatur = التصريح
Imprimaturs = التصاريح
Imprint = الأثر
Imprinted = مطبوع
Imprinting = الطباعة
Imprints = الآثار
Imprison = إسجن
Imprisoned = مسجون
Imprisoning = السجن
Imprisonment = السجن
Imprisonments = السجون
Imprisons = يسجن
Improbabilities = الاستبعاد
Improbability = اللا إحتمالية
Improbable = غير محتمل
Improbableness = حالة استبعاد الحدث
Improbably = بصورة غير محتملة
Impromptu = إرتجالا
Improper = غير صحيح
Improperly = بشكل غير صحيح
Improperness = صفة غير الملائمة
Impropitious = غير محبب
Improprieties = الأخطاء
Impropriety = الخطأ
Improvable = قابل للتحسين
Improve = تحسّن
Improved = محسّن
Improvement = التحسين
Improvements = التحسينات
Improver = المحسّن
Improvers = المحسّنون
Improves = يتحسّن
Improvidence = الإسراف
Improvident = مبذّر
Improvidently = بشكل مبذّر
Improving = التحسين
Improvisate = إمبروفيسات
Improvisation = الإرتجال
Improvisational = ارتجاليّ
Improvisations = الإرتجال
Improvisatory = إرتجالي
Improvise = إرتجل
Improvised = مرتجل
Improviser = المرتجل
Improvisers = المرتجلون
Improvises = يرتجل
Improvising = الإرتجال
Imprudence = الحماقة
Imprudent = أحمق
Imprudently = بشكل أحمق
Imps = العفاريت
Impudence = الوقاحة
Impudent = صفيق
Impudently = بشكل صفيق
Impugn = فنّد
Impugned = مفنّد
Impugner = الشكّاك
Impugning = التفنيد
Impugns = يفنّد
Impuls = إمبولس
Impulse = قوّة الدفع
Impulsed = أبدى رغبة
Impulses = قوّى الدفع
Impulsing = إبداء الرّغبة
Impulsion = الدافع
Impulsions = الدوافع
Impulsive = مندفع
Impulsively = بشكل مندفع
Impulsiveness = الإندفاع
Impunity = الحصانة
Impure = ملوّث
Impurely = بشكل ملوّث
Impureness = التلوّث
Impurities = الشوائب
Impurity = الشائبة
Imputable = قابل للإسناد
Imputation = الإتّهام
Imputations = الإتّهام
Impute = إنسب إليه
Imputed = منسوب إلى
Imputes = ينسب إليه
Imputing = النسب إلى
In = في
In-band = في الفرقة
In-bound = في الحدّ
In-circuit = في الدائرة
In-house = خاص
In-line = بالإتجاه نفسه
In-plane = في الطائرة
In-plant = في المصنع
In-process = في العملية
In-station = في المحطة
Inabilities = إنعدام القابليات
Inability = عدم القابلية
Inaccessibility = صعوبة الوصول
Inaccessible = صعب الوصول
Inaccessibleness = المناعة
Inaccessibly = بصعوبة
Inaccuracies = الأخطاء
Inaccuracy = الخطأ
Inaccurate = خاطئ
Inaccurately = بلا دقة
Inaccurateness = عدم الدّقة
Inaction = التكاسل
Inactions = التكاسل
Inactivate = عطّل
Inactivated = معطّل
Inactivating = التعطيل
Inactivation = التعطيل
Inactive = خامل
Inactively = بشكل خامل
Inactiveness = الخمول
Inactivity = الخمول
Inadaptable = غير قابل للتكيف
Inadequacies = النقائص
Inadequacy = النقص
Inadequate = ناقص
Inadequately = بشكل ناقص
Inadequateness = النقص
Inadmissibility = الرفض
Inadmissible = مرفوض
Inadmissibly = بشكل مرفوض
Inadvertence = الإهمال
Inadvertency = الإهمال
Inadvertent = غافل
Inadvertently = بشكل غير مقصود
Inadvisability = عدم الاستحسان
Inadvisable = غير مستحسن
Inalienable = ثابت
Inalienably = بثبات
Inalterable = غير قابل للتعديل
Inalterableness = الثّبات
Inane = فارغ
Inanely = تافها
Inaneness = التفاهة
Inaner = فارغ
Inanest = فارغ
Inanimate = غير متحرك
Inanimately = بشكل غير متحرك
Inanimateness = الموت
Inanity = السفاهة
Inapparent = غير ضاهر او واضح
Inapparently = بصورة غير ضاهرة او واضحة
Inappeasable = غير قابل للإرضاء
Inapplicability = اللاتطبيقية
Inapplicable = غير ملائم
Inapplicably = بطريقة غير ملائمة
Inappreciable = تافه
Inappreciably = بشكل دقيق
Inappreciative = غير مقدّر
Inappreciatively = بصورة غير تقديرية
Inappreciativeness = عدم التقدير
Inapproachable = صعب الوصول
Inapproachably = بشكل غير ودود
Inappropriate = غير ملائم
Inappropriately = على نحو غير ملائم
Inappropriateness = اللاتلائمية
Inapt = غير لائق
Inaptitude = إنعدام الذكاء
Inaptly = بشكل غير لائق
Inaptness = عدم قدرة
Inarguable = غير قابل للنّقاش
Inarguably = بطريقة غير قابلة للنّقاش
Inarticulate = لامفصلي
Inarticulately = بشكل لامفصلي
Inarticulateness = الغموض
Inartistic = غير فني
Inartistically = بلا حسّ فنّيّ
Inasmuch = بما أن
Inattention = السهو
Inattentive = غافل
Inattentively = بشكل غافل
Inattentiveness = السهو
Inaudibility = الخفوت
Inaudible = غير مسموع
Inaudibly = بشكل غير مسموع
Inaugural = إفتتاحي
Inaugurals = افتتاحيّات
Inaugurate = إفتتح
Inaugurated = مفتتح
Inaugurates = يفتتح
Inaugurating = الإفتتاح
Inauguration = التنصيب
Inaugurations = التنصيب
Inauspicious = مشؤوم
Inauspiciously = بشكل مشؤوم
Inauspiciousness = النحس
Inauthentic = زائف
Inauthenticity = الزّيف
Inbetween = في المنتصف
Inboard = داخلي
Inborn = غريزي
Inbounds = داخل الملعب
Inbox = صندوق الواردات
Inbred = طبيعي
Inbreed = توالد
Inbreeder = القائم على تزاوج الأقارب
Inbreeding = التوالد الداخلي
Inbuilt = داخليّ
Inc = المحدودة
Inca = إنكا
Incalculability = اللاتناهي
Incalculable = غير محسوب
Incalculableness = اللاتناهي
Incalculably = بدرجة كبيرة
Incandescence = الإنارة
Incandescent = منير
Incandescently = بشكل منير
Incant = إنكانت
