Incrementing = الزيادة
Increments = الزيادات
Incriminate = جرّم
Incriminated = مجرّم
Incriminates = يجرّم
Incriminating = التجريم
Incrimination = التوريط في الجريمة
Incriminatory = تجريمي
Incrustation = القشرة
Incrustations = القشور
Incrusted = مغطّى
Incubate = فقّس
Incubated = مفقّس
Incubates = يفقّس
Incubating = التفقيس
Incubation = الإحتضان
Incubative = حضني
Incubator = الحاضنة
Incubators = الحاضنات
Incubi = إنكوبي
Incubus = الكابوس
Inculcate = إطبع
Inculcated = مطبوع
Inculcates = يغرس
Inculcating = الغرس
Inculcation = التلقين
Inculpable = بريء
Inculpate = جرّم
Inculpated = مجرّم
Inculpates = يجرّم
Inculpating = التجريم
Incumbencies = المناصب
Incumbency = المنصب
Incumbent = صاحب المنصب
Incumbents = أصحاب المناصب
Incur = تحمّل
Incurability = العضالية
Incurable = العضول
Incurableness = العضالية
Incurables = العضولون
Incurably = بشكل غير قابل للشّفاء
Incurred = متحمّل
Incurring = التحمّل
Incurs = يتحمّل
Incursion = التوغّل
Incursions = التوغّلات
Indebted = مدين
Indebtedness = الدين
Indecencies = الفحش
Indecency = البذائة
Indecent = مخلّ بالآداب
Indecently = بطريقة مخلّة بالآداب
Indecipherable = عويص
Indecision = التردد
Indecisions = الترددات
Indecisive = غير حاسم
Indecisively = بشكل غير حاسم
Indecisiveness = التردّد
Indecomposable = غير قابل للتّحلّل
Indecorous = غير لائق
Indecorously = بشكل غير لائق
Indecorousness = إنديكوروسنيس
Indeed = في الحقيقة
Indefatigability = التحمّل
Indefatigable = نشيط
Indefatigableness = الحيوية، النّشاط
Indefatigably = بإصرار
Indefensibility = عدم الدّفاع
Indefensible = غير قابل للدفاع
Indefensibleness = إنعدام القدرة على الدفاع
Indefensibly = بشكل بالغ
Indefinability = بشكل غامض
Indefinable = غامض
Indefinableness = الغموض
Indefinite = غير محدد
Indefinitely = بشكل غير محدد
Indefiniteness = التشوّش
Indelibility = اللا زوالية
Indelible = دائم
Indelibleness = إنعدام القدرة على الإزالة
Indelibly = بشكل غير قابل للإزالة
Indelicacy = الخشونة
Indelicate = خشن
Indelicately = بشكل خشن
Indelicateness = الوقاحة
Indemnification = التأمين
Indemnified = مضمون
Indemnifies = يضمن
Indemnify = إضمن
Indemnifying = الضمان
Indemnities = الضمانات
Indemnity = الضمان
Indemonstrably = بشكل غير قابل للإثبات
Indent = الطلب الرسمي
Indentation = التثليم
Indentations = التثليم
Indented = مطعوج
Indenter = إندينتر
Indenting = الطعج
Indents = الطلبات الرسمية
Indenture = عقد العمل
Indentured = ملزم
Indentures = عقود العمل
Indenturing = الإلزام
Independence = الإستقلال
Independent = مستقل
Independently = بشكل مستقل
Independents = المستقلون
Indescribability = أنعدام قدرة الوصف
Indescribable = متعذر وصفه
Indescribableness = حالة إنتفاء قدرة الوصف
Indescribably = بشكل لا يوصف
Indestructibility = اللا إتلافية
Indestructible = راسخ
Indestructibleness = القوّة
Indestructibly = بشكل غير تدميري
Indeterminable = متعذّر التحديد
Indeterminableness = إنتفاء قدرة التحديد
Indeterminably = بشكل غير محدد
Indeterminacy = عدم التحديد
Indeterminate = غير محدّد
Indeterminately = بشكل غير محدّد
Indeterminateness = عدم التحديد
Indetermination = عدم التحديد
Indeterminism = اللاحتمية
Indeterministic = غير حتمي
Index = الدليل
Indexation = نظام إقتصادي - الفهرسة
Indexed = مفهرس
Indexer = واضع الفهرس
Indexes = الأدلة
Indexing = الفهرسة
India = الهند
Indian = الهندي
Indiana = إنديانا
Indianapolis = إنديانابوليس
Indians = الهنود
Indicant = مؤشّر
Indicants = المشيرون
Indicate = أشر إليه
Indicated = أشير إليه
Indicates = يشير إليه
Indicating = الإشارة إلى
Indication = الإشارة
Indications = الإشارات
Indicative = دلالي
Indicatively = بشكل دلالي
Indicatives = الأساليب الخبريّة
Indicator = المؤشر
Indicators = المؤشرات
Indices = الفهارس
Indict = إتّهم
Indictable = عرضة للإتهام
Indicted = متّهم
Indicter = المُدين، المُتّهِم
Indicting = الإتّهام
Indictment = الإتّهام
Indictments = الإتهامات
Indicts = يتّهم
Indie = مستقلّ
Indies = إنديز
Indifference = اللامبالاة
Indifferent = بلا مبالاة
Indifferently = بشكل بلا مبالاة
Indigence = الفاقة
Indigene = المواطن الأصليّ
Indigenous = أصلي
Indigenously = بشكل أصلي
Indigenousness = المحلّيّة
Indigent = فقير
Indigently = بشكل فقير
Indigested = غير مهضوم
Indigestibility = عسر الهضم
Indigestible = عسر الهضم
Indigestibleness = عُسر الهضم
Indigestibly = بشكل غير قابل للهضم
Indigestion = عسر الهضم
Indigestions = عسر الهضم
Indignant = ساخط
Indignantly = بسخط
Indignation = الإستياء
Indignations = الإستياء
Indignities = المذلّة
Indignity = المذلّة
Indigo = نيلي
Indira = إنديرا
Indirect = غير مباشر
Indirected = بلا إتجاه
Indirection = المراوغة
Indirections = المراوغات
Indirectly = بشكل غير مباشر
Indirectness = المراوغة
Indirectnesses = المراوغات
Indiscernible = متعذر تمييزه
Indiscernibleness = عدم الفهم
Indiscernibly = بطريقة غير مدركة
Indiscipline = العصيان
Indisciplined = غير مضبوط أو منتظم
Indiscoverable = غير ممكن اكتشافه
Indiscreet = أحمق
Indiscreetly = بشكل أحمق
Indiscreetness = الحماقة
Indiscretion = الطّيش
Indiscretions = الأعمال الطّائشة
Indiscriminate = عشوائي
Indiscriminately = عشوائيا
Indiscriminateness = اللاتفرقة
Indiscriminating = عشوائي
Indiscriminatingly = بشكل عشوائي
Indiscrimination = عدم التفرقة
Indiscriminative = عشوائي
Indiscriminatively = بشكل عشوائي
Indispensability = اللزومية
Indispensable = لا غنى عنه
Indispensableness = الضّروريّة
Indispensably = بشكل ضروريّ
Indispose = نفّر
Indisposed = متوعّك
Indisposes = ينفّر
Indisposing = التنفير
Indisposition = التوعك
Indisputability = إنعدام الشّك
Indisputable = غير قابل للجدال
Indisputableness = التأكيد
Indisputably = بشكل غير قابل للجدل
Indissociable = غير قابل للإنفصال
Indissolubility = اللا إنحلالية
Indissoluble = غير قابل للذوبان
Indissolubleness = الرّسوخ
Indissolubly = بشكل راسخ
Indistinct = غامض
Indistinctive = غير مميّز
Indistinctly = بغموض
Indistinctness = الغموض
Indistinguishability = بشكل يتعذّر تميزه
Indistinguishable = متعذر تميزه
Indistinguishableness = اللا تميّز
Indistinguishably = بشكل غير مميز
Indite = نظّم
Indited = منظّم
Indites = ينظّم
Inditing = التنظيم
Indium = إنديوم
Individual = الفرد
Individualism = الفردية
Individualist = الأناني
Individualistic = فردي
Individualistically = في سلوك فرديّ
Individualists = الأنانيون
Individuality = الفردية
Individualization = شخّص، فصّل
Individualizations = التشخيصات، التفصيلات
Individualize = خصّص
Individualized = مخصّص
Individualizer = فصّل، شخّص
Individualizes = يخصّص
Individualizing = التخصيص
Individually = بشكل منفرد
Individuals = الأفراد
Individuate = يتفرّد
Individuated = تفرّد
Individuates = يتفرّد
Individuating = التّفرّد
Individuation = التّميّز
Indivisibility = عدم القابلية للقسمة
Indivisible = غير قابل للقسمة
Indivisibleness = ألا تجزئة
Indivisibly = بشكل غير قابل للانقسام
Indochina = الهند الصينية
Indochinese = هندي صيني
Indocile = عنود
Indoctrinate = لقّن
Indoctrinated = ملقّن
Indoctrinates = يلقّن
Indoctrinating = التلقين
Indoctrination = التلقين
Indoctrinator = المعلّم، المدرّس
Indoeuropean = هنديّ أوروبّيّ
Indolence = الكسل
Indolent = كسول
Indolently = بشكل كسول
Indomitability = اللا خضوعية
Indomitable = لا يقهر
Indomitableness = اللا قهر
Indomitably = بشكل لا يقهر
Indonesia = أندونيسيا
Indonesian = الأندونوسي
Indoor = داخلي
Indoors = في الداخل
Indorse = صدّق
Indubitable = مؤكّد
Indubitableness = بلا شك
Indubitably = بلا شكّ
Induce = أقنع
Induced = مستحثّ
Inducement = الحافز
Inducements = الحوافز
Inducer = المولّد - جينات
Induces = يقنع
Inducible = قابل للتولّد
