Inflamer = المهيّج
Inflames = يلهب
Inflaming = الإلهاب
Inflammability = قابلية الإشتعال
Inflammable = قابل للاشتعال
Inflammableness = قابلية الإشتعال
Inflammably = بصورة سريعة الإشتعال
Inflammation = الإلتهاب
Inflammations = الإلتهابات
Inflammatory = تحريضي
Inflatable = قابل للنفخ
Inflate = إنفخ
Inflated = منتفخ
Inflater = النّافخ
Inflates = ينفخ
Inflating = النفخ
Inflation = التضّخم
Inflationary = تضخّمي
Inflations = التضّخم
Inflect = قوّس
Inflected = مقوّس
Inflecting = التقويس
Inflection = التصريف
Inflectional = إعرابي
Inflectionally = تصريفيا
Inflections = الإلتواءات
Inflective = عطفي
Inflects = يقوّس
Inflexed = منحني
Inflexibility = اللامرونة
Inflexible = صلب
Inflexibleness = الصرامة
Inflexibly = بعناد
Inflexion = الإلتواء
Inflexions = الإلتواءات
Inflict = أوقع
Inflicted = موقع
Inflicter = المصيب
Inflicting = الإيقاع
Infliction = الإصابة
Inflictive = ضارب
Inflicts = يوقع
Inflow = الجريان
Inflows = التدفّقات
Influence = التأثير
Influenced = متأثر
Influencer = المؤثّر
Influences = التأثيرات
Influencing = التأثير على
Influent = مؤثر
Influential = مؤثر
Influentially = بشكل مؤثر
Influenza = الإنفلونزا
Influx = التدفّق
Info = المعلومات
Infold = إطو
Infolded = مطوي
Infolding = الطوي
Infolds = يطوى
Inform = أعلم
Informal = غير رسمي
Informality = الشكلية
Informally = بشكل غير رسمي
Informant = المخبر
Informants = المخبرون
Information = المعلومات
Informational = معلوماتي
Informations = المعلومات
Informative = غني بالمعلومات المفيدة
Informatively = بشكل غني بالمعلومات المفيدة
Informativeness = الثّقافة
Informed = مطّلع
Informer = المخبر
Informers = المخبرون
Informing = الإعلام
Informs = يعلم
Infra = تحت
Infract = خالف
Infraction = الإخلال
Infractions = الإخلالات
Infrared = الأشعة تحت الحمراء
Infrasonic = تحت صوتيّ
Infrastructure = البناء التحتي
Infrastructures = البنى التحتية
Infrequence = الندرة
Infrequency = الندرة
Infrequent = نادر
Infrequently = بشكل نادر
Infringe = خالف
Infringed = مخالف
Infringement = الإنتهاك
Infringements = الإنتهاكات
Infringer = المنتهك
Infringes = يخالف
Infringing = المخالفة
Infuriate = أغضب
Infuriated = غاضب
Infuriates = يغضب
Infuriating = الإغضاب
Infuriatingly = بشكل يدعو للضّيق
Infuriation = الغضب الشديد
Infuse = صبّ
Infused = مصبوب
Infuser = المساعد على التحلّل
Infuses = يصبّ
Infusible = غير قابل للإنصهار
Infusibleness = اللاإنصهارية
Infusing = الصبّ
Infusion = الصبّ، الحقن، الغرس
Infusions = الصبّ
Ingather = إنجاثر
Ingel = إنجيل
Ingenious = مبدع
Ingeniously = بشكل مبدع
Ingeniousness = الذكاء
Ingenue = الفتاة الساذجة
Ingenuities = الإبداعات
Ingenuity = الإبداع
Ingenuous = صريح
Ingenuously = بشكل صريح
Ingenuousness = السذاجة
Ingersoll = إنجيرسول
Ingest = إبتلع
Ingested = مبتلع
Ingestible = قابل للهضم
Ingestion = الإبتلاع
Ingestive = هضمي
Ingests = يبتلع
Inglenook = ناحية الموقد
Inglorious = غير مشرّف
Ingloriously = بشكل غير مشرّف
Ingloriousness = الخزي
Ingot = القالب
Ingots = القوالب
Ingrain = رسّخ
Ingrained = متشرّب
Ingrainedly = بشكل متشرّب
Ingrains = يرسّخ
Ingram = إنجرام
Ingrate = ناكر الجميل
Ingratiate = تزلّف
Ingratiated = متزلّف
Ingratiates = يتزلّف
Ingratiating = التزلّف
Ingratiatingly = بشكل متزلّف
Ingratiation = الحُظِيْ
Ingratitude = الجحود
Ingredient = المكون
Ingredients = المكونات
Ingress = الدخول
Ingresses = الدخول
Ingrowing = نام للداخل
Ingrown = نام للداخل
Ingrownness = النّمو الى الدّاخل
Ingrowth = النّموّ الدّاخليّ
Ingrowths = النّموّ الدّاخليّ
Inguinal = أربيّي
Inhabit = إسكن
Inhabitability = مدى صلاحية المكان للسكن
Inhabitable = غير صالح للسكن
Inhabitance = السكنى
Inhabitancy = السكنى
Inhabitant = الساكن
Inhabitants = السكّان
Inhabitation = السكنى
Inhabited = مسكون
Inhabiter = الساكن
Inhabiters = السكنة
Inhabiting = السكون
Inhabits = يسكن
Inhalant = المستنشق
Inhalants = المستنشقات
Inhalation = الإستنشاق
Inhalations = الإستنشاق
Inhale = إستنشق
Inhaled = مستنشق
Inhaler = المستنشق
Inhales = يستنشق
Inhaling = الإستنشاق
Inharmonic = متنافر
Inharmonious = متنافر
Inharmoniously = بشكل متنافر
Inharmoniousness = التّنافر
Inhere = لازم
Inhered = ملازم
Inherence = التلازم
Inherent = متأصّل
Inherently = أصلا
Inheres = يلازم
Inhering = الملازمة
Inherit = رث
Inheritable = موروث
Inheritableness = القابلية للتوريث
Inheritance = الميراث
Inheritances = المواريث
Inherited = موروث
Inheriting = الوراثة
Inheritor = الوارث
Inheritors = الورثة
Inheritress = الوريثة
Inheritrix = الوريثة
Inherits = يرث
Inhibit = إمنع
Inhibited = حسّاس
Inhibiter = المانع
Inhibiting = المنع
Inhibition = المنع
Inhibitions = المنع
Inhibitive = تحريمي
Inhibitor = المانع
Inhibitors = المانعون
Inhibitory = تحريمي
Inhibits = يمنع
Inholding = أرض خاصّة في وسط أرض عامّة
Inholdings = أراضي خاصّة في وسط أرض عامّة
Inhomogeneities = إنعدام التّجانس
Inhomogeneity = التّجانس
Inhomogeneous = متغاير
Inhospitable = قاس
Inhospitableness = القساوة
Inhospitably = بشكل رديء
Inhospitality = بلا حفاوة
Inhuman = لا إنساني
Inhumane = لا إنساني
Inhumanely = بشكل لا إنساني
Inhumanities = الوحشيّة
Inhumanly = بشكل لا إنساني
Inhumanness = القسوة
Inhume = إدفن
Inhumed = مدفون
Inhuming = الدفن
Inimical = عدائي
Inimically = بشكل عدائي
Inimitability = فريد
Inimitable = غير قابل للتقليد
Inimitableness = فريد
Inimitably = بشكل غير قابل للتّقليد
Inion = عظمة في أسفل الجمجمة
Iniquities = الظّلم
Iniquitous = جائر
Iniquitously = بشكل جائر
Iniquitousness = الظلم
Iniquity = الظلم
Init = إختصار ل الحرف الأوّل
Initial = الأولي
Initialed = وقّع بالأحرف الأولى
Initialer = أولي
Initialing = توقيع بالأحرف الأولى
Initialization = التهيئة
Initializations = التهيئة
Initialize = شغّل
Initialized = شغّل
Initializer = المعدّ
Initializers = المعدّون
Initializes = يشغّل
Initializing = التشغيل
Initially = أوليا
Initialness = البداية
Initials = حروف الاسم الأولى
Initiate = مستهلّ
Initiated = مبدوء
Initiates = المبتدئون
Initiating = البدء
Initiation = التلقين
Initiations = التلقين
Initiative = المبادرة
Initiatively = بشكل أولي
Initiatives = المبادرات
Initiator = البادئ
Initiators = البادئون
Inject = إحقن
Injectable = قابل للحقن
Injected = محقون
Injecting = الحقن
Injection = الحقن
Injections = الحقن
Injective = العملية الرياضيّة المتوافقة
Injector = الحاقن
Injects = يحقن
Injudicious = غير حكيم
Injudiciously = بشكل غير حكيم
Injudiciousness = الطيش
Injun = إينجن - مصطلح بغيض للأمريكيّين الأصليّين
Injunction = الأمر
Injunctions = الأوامر
Injunctive = تحذيري
Injure = إجرح
Injured = جريح
Injurer = المؤذي
Injures = يجرح
Injuries = الإصابات
Injuring = الجرح
Injurious = تجريحي
Injuriously = بشكل تجريحي
Injuriousness = الضرر
Injury = الجرح
Injustice = الظلم
Injustices = الظلم
Ink = الحبر
Ink-eraser = محّاية حبر
