Isaacs = إيساكس - قانونيّ أستراليّ
Isaacson = إيزاسون
Isabel = إيزابيل
Isabella = إيزابيلا
Isadore = إيزادور
Isaiah = أشعيا
ISDN = شبكة رقمية ذات خرمات متكاملة
Isentropic = بدون التّغيير في الانتروبيا
Isfahan = إصفهان
Ising = إيسينج
Isinglass = إيسينج - جيلاتين شفّاف, نقيّ تقريبًا
Isis = إيزيس - الرّبّة الرّئيسيّة المعبودة من قبل المصريّين, أساطير
Islam = الإسلام
Islamabad = إسلام آباد
Islamic = إسلامي
Island = الجزيرة
Islander = ساكن الجزيرة
Islanders = سكنة الجزيرة
Islandia = إيزلانديا
Islands = الجزر
Isle = الجزيرة
Isles = الجزر
Islet = الجزيرة
Islets = الجزر
Isling = لعمل جزيرة من..
ISO = الأيزو
ISO-Size = حجم آيسو
Isobar = الأيسوبار
Isobars = الأيسوبار
Isochronal = متساوي في المدّة
Isochronally = بتساوي في المدّة
Isochronous = متساوي في المدّة
Isochronously = بتساوي في المدّة
Isocline = طرف متماثل الميل
Isocyanate = أيزوسيانيت - ملح
Isolate = إعزل
Isolated = معزول
Isolates = يعزل
Isolating = العزل
Isolation = العزلة
Isolationism = الإنعزالية
Isolationist = المعتزلي
Isolationistic = انعزاليّ
Isolationists = المعتزلة
Isolations = العزلة
Isolde = أيسولد - في أسطورة أرثرايان, الأميرة الأيرلنديّة التي تزوّجت ملك كورنوول
Isomer = الأيسومر
Isomeric = أيسومري
Isomers = الأيسومر
Isometric = متساوي القياس
Isometrical = متعلق بتساوي القياس
Isometrically = متساوو القياس
Isometrics = التّمارين الرّياضيّة
Isomorph = المماثل
Isomorphic = متماثل
Isomorphically = بشكل متماثل
Isomorphism = التّماثل
Isomorphisms = التّماثل
Isopleth = خط يرسم على الخريطة يقوم بالتوصيل بين عدة نقاط
Isoprene = أيسوبرين - سائل متطاير عديم اللّون
Isopropyl = الآيزوبروبيل
Isosceles = متساوي الساقين
Isotherm = الأيسوثرم
Isothermal = متساوي الحرارة
Isothermally = بشكل متساوي الحرارة
Isotherms = الأيسوثرم
Isotonic = متساوي التّوتّر
Isotope = النظائر المشعة
Isotopes = النظائر المشعة
Isotopic = أحاديّ النّظير
Isotropic = موحّد الخواصّ
Isotropy = توحّد الخواصّ
Isp = شركة خدمات الإنترنت،  مزوّد خدمات الإنترنت
Israel = إسرائيل
Israeli = المواطن الإسرائيلي :: متعلّق بإسرائيل او مواطنيها
Israelis = الإسرائيليون
Israelite = الإسرائيلي
Israelites = الإسرائيليون
Iss = المحطّة الفضائيّة الدّوليّة
Issuable = قابل الإصدار
Issuance = الإصدار
Issuances = الإصدار
Issuant = الإصدار
Issue = القضية
Issued = مصدر
Issueless = بدون موضوع
Issuer = المصدّر
Issuers = المصدّرون
Issues = القضايا
Issuing = الإصدار
Istanbul = إسطنبول
Isthmus = البرزخ
Isthmuses = البرازخ
Istvan = إيزتفان
It = هو
Italian = الإيطالي
Italians = الإيطاليون
Italic = مائل
Italicize = ميّل
Italicized = ميّال
Italicizes = يميّل
Italicizing = الميلا
Italics = إتاليس
Italy = إيطاليا
Itch = الحكّة
Itched = محكوك
Itches = الحكّة
Itchier = حاك
Itchiest = حاك
Itchiness = الحكّ
Itching = الحكّ
Itchy = حاك
Item = المادة
Itemise = فصّل
Itemization = التفصيل
Itemizations = التفصيل
Itemize = فصّل
Itemized = مفصّل
Itemizer = المصنّف
Itemizers = المصنّفون
Itemizes = يفصّل
Itemizing = التفصيل
Items = المواد
Iterate = كرّر
Iterated = مكرّر
Iterates = يكرّر
Iterating = التكرار
Iteration = التكرار
Iterations = التكرار
Iterative = تكراري
Iteratively = بشكل تكراري
Iterator = من يحصل على أي عنصر من قائمة عناصر - برمجيّات
Ithaca = إيثيكا
Itinerant = متجوّل
Itinerantly = بشكل متجوّل
Itineraries = المخططات
Itinerary = مخطّط الرحلة
Ito = منظمة التجارة الدولية
Its = له
Itself = نفسه
ITT = تكنولوجيا المعلومات و تكنولوجيا الاتّصالات
IUD = اللّولب
IUDs = اللوالب
Iv = الرّابع
Ivan = إيفان
Ivanhoe = إفانهوي
Iverson = إفيرسون
Ivied = مكسوّ باللّبلاب
Ivies = أشجار اللبلاب
Ivories = العاج
Ivory = العاج
Ivy = آيفي
Ix = الرقم تسعة
Izaak = إسحاق
Izvestia = إزفيستيا
Internet protocol = بروتوكول الإنترنت
J = جي - الحرف العاشر في اللغة الإنجليزية
Jab = الأبرة
Jabbed = وخز
Jabber = الثرثار
Jabbered = مثرثر
Jabbers = الثرثارون
Jabberwocky = الثرثرة
Jabbing = الوخز
Jablonsky = جابلونسكاي
Jabs = الأبر
Jack = جاك
Jack-of-all-trades = المشتغل في كل الأعمال
Jack-pot = الجائزة
Jackal = الثعلب
Jackals = الثعالب
Jackanapes = الوقح
Jackass = الحمار
Jackasses = الحمير
Jackboot = الجزمة
Jackbooted = عدوانيّ
Jackboots = الجزم
Jackdaw = الغراب
Jackdaws = الغربان
Jacked = جاكيد
Jacker = جاكير
Jacket = السترة
Jacketed = مرتدي جاكت
Jackets = الستر
Jackie = جاكي
Jacking = الاصطياد
Jackknife = المطواة
Jackman = جاكمان
Jackpot = الجائزة الأولى
Jackpots = الجوائز الأولى
Jacks = الرافعات
Jackson = جاكسن
Jacksonian = متعلق بـ أندرو جاكسون
Jacksonville = جاكسونفيل
Jacky = جاكي
JACM = صحيفة جمعيّة الآلات الحاسبة
Jacob = يعقوب
Jacobean = يعقوبي
Jacobi = جاكوبي
Jacobian = التّعلّق بطراز معماريّ و ديكور في وقت جيمس الأوّل
Jacobite = يعقوبي
Jacobs = جاكوبس
Jacobsen = جاكوبسين
Jacobson = جاكوبسون
Jacobus = جاكوبوس
Jacoby = جاكوبي
Jacqueline = جاكلين
Jacques = جاك
Jade = اليشم
Jaded = متعب
Jadedly = بانهاك
Jadedness = التّعب
Jades = الساقطات
Jading = الإتعاب
Jaeger = الكركر
Jag = النتوء
Jagged = متعرج
Jaggedly = بتعرّج
Jaggedness = الخشونة
Jaggers = ييجرز
Jagging = التكسير
Jaggy = جاجي
Jags = النتوءات
Jaguar = الفهد
Jaguars = النمور
Jail = السجن
Jailbird = خرّيج السّجون
Jailbirds = خرّيجو السّجون
Jailbreak = الهروب من السجن
Jailed = مسجون
Jailer = السجّان
Jailers = السجّانون
Jailhouse = السّجن
Jailing = السجن
Jails = السجون
Jaime = جيم
Jakarta = جاكارتا
Jake = جايك
Jakes = المرحاض
Jalopies = السيارات القديمة
Jalopy = السيارة القراضة
Jam = المربّى
Jamaica = جامايكا
Jamaican = الجامايكي
Jamb = العضادة
Jamboree = المهرجان
Jambs = العضائد
James = جيمس
Jameson = جيمسن
Jamestown = جيمستاون
Jammed = مسدود
Jammer = جهاز التّشويش
Jamming = التشويش
Jams = المربات
Jan = يناير/كانون الثّاني
Jane = جين
Janeiro = جانيرو
Janesville = جاينسفيل
Janet = جانيت
Jangle = الخشخشة
Jangled = مخشخش
Jangler = الخشخاشة
Jangles = الخشخشات
Jangling = الخشخشة
Janice = جانيس
Janis = جانيس
Janissaries = الإنكشاريون
Janissary = الإنكشاري
Janitor = البوّاب
Janitorial = متعلق بصيانة المباني
Janitors = البوابون
Janos = يونس
Jansen = جانسين
Jansenist = تابع كورنليوس جانسين
Januaries = أشْهُرْ يناير
January = يناير/كانون الثّاني
Janus = يانوس - أساطير رومانيّة . اله البوّابات و المداخل
Japan = اليابان
Japanese = الياباني
Jape = إخدع
Japed = مخدوع
Japing = السخرية من
Jar = الجرّة
Jargon = المفردة التخصصية
Jargons = المفردات التخصصية
Jarred = متنافر
Jarring = التنافر
Jarringly = بشكل مزعج
Jars = الجرار
Jarvin = جارفين
Jasmines = الياسمين
Jason = جايسون
Jasper = كاسبر
Jaspers = اليشب
Jastrow = جاسترو
Jaundice = اليرقان
Jaundiced = صفراوي
Jaundices = اليرقان
Jaundicing = تصفّر بياض العين أو البشرة
Jaunt = النزهة
