Laundresses = الغسّالات
Laundrette = المغسلة - مكان غسيل الملابس
Laundrettes = المغاسل - أماكن غسيل الملابس
Laundries = المكاوي
Laundromat = مكان غسل الثياب
Laundromats = المغاسل - أماكن غسيل الملابس
Laundry = المكوى
Laundrymen = منظّفو الملابس
Laura = لورا
Laureate = الفائز
Laureated = كرّم بوضع تاج الغار على الرأس
Laureates = الفائزون
Laureateship = مكتب التكريم
Laureating = التكريم بوضع تاج الغار على الرأس
Laureation = التكريم بوضع تاج الغار على الرأس
Laurel = الغار
Laureled = توّج بأوراق الغار
Laurels = نبات الغار
Lauren = لورين
Laurence = لورنس
Laurent = لورنت
Laurentian = متعلق بنهر القدّيس لورانس
Laurie = لوري
Lausanne = لوزان
Lava = الحمم
Lavabo = الاغتسال
Lavatories = المراحيض
Lavatory = المرحاض
Lave = إغتسل
Laved = مغتسل
Lavender = اللافندر
Lavendered = مكسو بنبات اللافيندر
Lavendering = التعطير او التطييب باستخدام نبات اللافيندر
Laves = يغتسل
Laving = الإغتسال
Lavish = مسرف
Lavished = مغدق
Lavishing = الإغداق
Lavishly = بشكل مسرف
Lavishness = البذخ
Lavoisier = لافويسير - صيدليّ فرنسيّ
Law = القانون
Lawbreaker = منتهك القانون
Lawbreakers = منتهكي القانون
Lawbreaking = خرق القانون
Lawford = لوفورد
Lawful = قانوني
Lawfully = بشكل شرعي
Lawfulness = الشرعية
Lawgiver = المشرّع
Lawgivers = المشرّعون
Lawgiving = التشريع
Lawless = فوضوي
Lawlessly = بشكل فوضوي
Lawlessness = الفوضى
Lawlessnesses = الفوضى
Lawmaker = المشرّع
Lawmakers = المشرّعون
Lawmaking = تشريع القوانين
Lawman = الموظف المسؤول عن تنفيذ القانون
Lawmen = الموظفون المسؤولون عن تنفيذ القانون
Lawn = العشب
Lawns = المعاشب
Lawrence = لورانس
Lawrenceville = لورينسيفيل
Lawrencium = اللورنسيوم - عنصر مشعّ
Laws = القوانين
Lawson = لوسون
Lawsuit = الدعوى
Lawsuits = الدعاوي
Lawyer = المحامي
Lawyerly = يصير محامياً
Lawyers = المحامون
Lax = لاكس
Laxativ = لاكساتيف
Laxative = المسهّل
Laxatively = بشكل مسهّل
Laxativeness = التّسهيل
Laxatives = المسهلات
Laxity = التهاون
Laxly = رخوا
Laxness = الإهمال
Lay = عاميّ
Layer = الطبقة
Layered = ذو طبقات
Layering = التصفيف
Layers = الطبقات
Layette = مستلزمات الوليد
Laying = الوضع
Layman = الرجل الغير المتخصّص
Laymen = الرجال الغير المتخصّصين
Layoff = البطالة
Layoffs = حالات البطالة
Layout = التخطيط
Layouts = المخططات
Layover = توقّف قصير إبّان الرّحلة
Layperson = شخص عادي
Lays = الأناشيد
Layton = ليتون
Layup = رمية الكرة
Layups = رميات الكرة
Lazar = الليزر
Lazarus = لازاروس - في العهد الجديد. أخو ماري و مارثا
Laze = تكاسل
Lazed = متكاسل
Lazes = يتكاسل
Lazied = تحرّك ببطىء او كسّل
Lazier = أشدّ كسلا
Laziest = أشدّ كسلا
Lazily = بتكاسل
Laziness = الكسل
Lazing = التكاسل
Lazy = كسلان
Lazybones = الكسول
Lazying = التّحرك ببطىء او الكسل
Lb = الباون
Lbs = الباونات
Lea = لي
Leach = الترشيح
Leachate = ليتشات
Leached = مرشّح
Leaches = الترشيح
Leaching = الترشيح
Lead = التقدّم
Leaded = مرصّص
Leaden = رصاصي
Leadenly = بشكل رصاصي
Leadenness = الرصاصية، الثِّقل
Leader = الزعيم
Leaderless = بلا قائد
Leaders = الزعماء
Leadership = القيادة
Leaderships = القيادات
Leading = القيادة
Leading-in = قيادي في
Leadings = الإطار المصنوع من الرصاص
Leadoff = متقدّم
Leads = الأدلّة
Leadsman = من يحدد عمق البحر على متن السفينة
Leadsmen = محددو عمق البحر على متن السفينة
Leaf = الورقة
Leafage = ورق الشجر
Leafed = مورق
Leafhopper = حشرة نطاطة
Leafier = محاط بالأشجار
Leafiest = محاط بالأشجار
Leafing = الإيراق
Leafless = بلا أوراق
Leaflet = ورقة الإعلان
Leaflets = أوراق الإعلانات
Leafs = الورقة
Leafy = محاط بالأشجار
League = الإتحاد
Leagued = شارك في المنظّمة
Leaguer = العضو
Leaguers = الأعضاء
Leagues = الفرق
Leaguing = التنظيم لمنظّمة
Leak = التسرّب
Leakage = التسرب
Leakages = التسرب
Leaked = مسرّب
Leaker = المسرّب
Leakier = أكثر نضوحا
Leakiest = أكثر نضوحا
Leakiness = التسرّب
Leaking = التسريب
Leaks = التسرّبات
Leaky = ناضح
Lean = اللحم بدون دهن
Leander = ليندر
Leaned = متّكأ
Leaner = أكثر طراوة
Leanest = أكثر طراوة
Leaning = الميل
Leanings = الميول
Leanly = بشكل طري
Leanness = الطراوة
Leans = الميول
Leant = ميل
Leap = القفزة
Leap-day = يوم قفزة
Leap-frog = ضفدع قفزة
Leap-year = سنة الكبيسة
Leaped = قافز
Leaper = القافز
Leapfrog = قفز الضفادع
Leapfrogs = يقفز
Leaping = القفز
Leaps = القفزات
Leapt = قافز
Lear = لير
Learn = تعلّم
Learnable = قابل للتعلّم
Learned = متعلّم
Learnedly = مكتسبا
Learnedness = التعلّم
Learner = المتعلّم
Learners = المتعلّمون
Learning = التعلّم
Learnings = التّعلّم
Learns = يتعلّم
Learnt = تعلّم
Leary = ليري
Leasable = قابل للتأجير
Lease = الإيجار
Leased = مؤجّر
Leasehold = العقار المستأجر
Leaseholder = المستأجر
Leases = عقود الإيجار
Leash = المقود
Leashes = المقاود
Leasing = التأجير
Least = أقلّ
Leastwise = على الأقل
Leather = الجلد
Leatherback = ليذرباك - أكبر سلحفاة بحريّة
Leathered = جَلَدَ
Leathering = الجَلْد
Leathern = جلدي
Leatherneck = جندي من مشاة البحرية الأمريكية
Leathers = الجلود
Leatherwork = الأعمال الجلدية
Leathery = جلدي
Leave = الإجازة
Leaved = أورق
Leaven = الخميرة
Leavened = مخمّر
Leavening = التخفيف
Leavenworth = ليفينورث
Leaver = التارك
Leavers = التاركون
Leaves = الأوراق
Leaving = الترك
Leavings = الفضلات
Lebanese = الّلبناني، الّلبنانيّة
Lebanon = لبنان
Lebensraum = المجال الحيوي
Lebesgue =  ليبيسج - عالم رياضيّات فرنسي
Lecher = الفاسق
Lecherous = داعر
Lecherously = بشكل داعر
Lecherousness = الفجور
Lechery = الفجور
Lectern = المنصّة الخطابية
Lecterns = المنصّات الخطابية
Lectionary = الفصول من الإنجيل التي سيتم قرائتها داخل الكنيسة
Lecture = المحاضرة
Lectured = محاضر
Lecturer = المحاضر
Lecturers = المحاضرون
Lectures = المحاضرات
Lectureship = منصب المحاضر
Lecturing = المحاضرة
Led = مقاد
Ledge = الحافة
Ledger = سجل الحسابات
Ledger-card = بطاقة سجل حسابات
Ledgers = سجلات الحسابات
Ledges = الحواف
LEDs = نظام بيانات تطبيق القانون
Lee = لي
Leech = المستنزف
Leeched = ليتشيد
Leeches = المستنزفون
Leeching = الإمتصاص
Leeds = ليدز
Leek = الكرّاث
Leeks = نبات الكرّاث
Leer = الخزرة
Leered = شابق
Leerier = أكثر إرتيابا
Leeriest = أكثر إرتيابا
Leeriness = الحذر
Leering = الشبق
Leeringly = بشكل شابق
Leers = الخزر
Leery = مرتاب
Lees = الثمالة
Leeuwenhoek = ليوينهويك
Leeward = بإتجاه الريح
Leeway = الفسحة
Left = اليسار
Left-Auxiliary = المساعد اليسار
Left-Channel = القناة اليسرى
Left-InternalSpeaker = إنترنالسبيكير اليسار
Left-Jack = جاك اليسار
Left-justified = مبرّر يسار
Left-Microphone = مكبّر الصوت اليسار
Lefties = اليساريّون
Leftist = يساري
Leftists = اليساريون
Leftmost = أقصى اليسار
Leftover = البقية
Leftovers = البقايا
Lefts = اليسار
Leftward = يساري
Leftwards = على اليسار
Lefty = اليساريّ
Leg = الساق
