Mileages = المسافات بالأميال
Miler = ميلير
Miles = أميال
Milestone = المعلم
Milestones = المعالم
Milieu = البيئة
Milieus = البيئات
Militancy = القتال
Militant = مناضل
Militantly = بروح فدائية
Militantness = النضاليّة
Militants = مناضلون
Militaries = الجيوش
Militarily = عسكريا
Militarism = العسكرية
Militarisms = العسكرية
Militarist = خبير عسكري
Militaristic = مشرب بالروح الحربية
Militaristically = بدعم للعسكرية
Militarization = العسكرة
Militarize = عسكر
Militarized = معسكر
Militarizes = يعسكر
Militarizing = العسكرة
Military = الجيش
Militate = ناهض
Militated = مناهض
Militates = يناهض
Militating = المناهضة
Militia = المقاومة الشعبية
Militiamen = جنود الجيش الشعبي
Militias = الجيوش الشعبية
Milk = الحليب
Milked = محلوب
Milker = الحالب
Milkers = الحالبون
Milkier = حليبي
Milkiest = حليبي
Milkiness = الحليبية
Milking = الحلب
Milkmaid = الحلابة
Milkmaids = الحلابات
Milkman = بائع الحليب
Milkmen = باعة الحليب
Milks = يحلب
Milksop = المخنث
Milksops = المخنثون
Milkweed = حشيشة اللبن (نبات)
Milky = حليبي
Mill = الطاحونة
Millard = ميلارد
Mille = ميل
Milled = مطحون
Millenarian = ألفي: متعلق بألف سنة
Millenarianism = الإيمان بالعصر الألفي السعيد
Millenia = قرون من الزّمن
Millennia = الألفيات
Millennialism = الإيمان بالعصر الألفيّ
Millennium = الألفية
Millepede = أم أربعة وأربعين
Millepedes = أمهات أربعة وأربعين
Miller = طحّان
Millers = طحّانون
Milles = ميليس
Millet = الدخن
Milliamp = جزء من ألف جزء من الأمبير
Milliampere = جزء من ألف جزء من الأمبير
Milliamperes = جزء من ألف جزء من الأمبير
Milliard = المليار
Millidegree = جزء من ألف جزء من الدرجة
Millidegrees = جزء من ألف جزء من الدرجة
Millie = ميلي
Milligram = الملليغرام
Milligrams = الملليغرامات
Millijoule = جزء من ألف جزء من الجول
Millijoules = جزء من ألف جزء من الجول
Millikan = ميليكان
Milliliter = الملليلتر
Milliliters = الملليلترات
Millimeter = الملليمتر
Millimeters = المليمترات
Millimetre = الملليمتر
Milliner = بائع قبعات النساء
Millineries = متاجر قبعات النساء
Milliners = باعة قبعات النساء
Millinery = صناعة قبعات النساء
Milling = الطحن
Million = مليون
Millionaire = المليونير
Millionaires = المليونيرات
Millioned = مضروب في الملايين
Millions = الملايين
Millionth = مليون
Millipede = أم أربعة وأربعين
Millipedes = أمهات أربعة وأربعين
Millisecond = جزء من الألف من الثانية
Milliseconds = جزء من ألف جزء من الثانية
Millisecs = جزء من ألف جزء من الثانية
Millivolt = جزء من ألف جزء من الفولت
Millivoltmeter = مقياس مُدرَّج بالميليفولت
Millivoltmeters = أجهزة قياس مُدرَّجة بالميليفولت
Millivolts = جزء من ألف جزء من الفولت
Milliwatt = جزء من ألف جزء من الواط
Milliwatts = جزء من ألف جزء من الواط
Millpond = بركة الطاحون
Mills = طواحين
Millstone = حجر الرحّى
Millstones = أحجار الرحّى
Millwright = مركب الطواحين
Millwrights = مركبو الطواحين
Milord = الميلورد
Milquetoast = الجبان
Milquetoasts = الجبناء
Milt = لقّح
Milton = ميلتن
Miltonic = ملتونيّ: ذو علاقة بالشاعر الإنكليزي ملتون أو بشعره أو مميِّز لهما
Milwaukee = ميلووكي
MIMD = عمليات مختلفة على بيانات مختلفة (Multiple Instruction Multiple Data)
Mime = التمثيلية الصامتة
Mime-Type = من نوع تمثيلية صامتة
Mimed = مقلّد
Mimeograph = الناسخة
Mimeographed = نسخ
Mimeographes = ناسخات
Mimeographing = نسخ
Mimeographs = ناسخات
Mimer = مهرِّج
Mimes = تمثيليات صامتة
Mimesis = تقليد
Mimetic = متسّم بالتقليد والمحاكاة
Mimetically = بطريقة ساخرة (من طريق التقليد والمحاكاة)
Mimetypes = أنواع الملفات
Mimi = ميمي
Mimic = مقلّد
Mimicked = حاكى أو قلّد للتسلية
Mimicking = يقلّد
Mimicries = التقاليد
Mimicry = محاكاة
Mimics = المقلدون
Miming = التقليد
Min = دقيقة
Minaret = المئذنة
Mince = اللحم المفروم
Minced = مثروم
Mincemeat = اللحم مفروم
Mincer = المفرمة
Mincers = المفارم
Minces = اللحوم المفرومة
Mincing = الثرم
Mincingly = بشكل متكلف
Mind = عقل
Mindanao = جزيرة جنوب الفلبين
Minded = متدبّر
Mindedness = ذو عقل
Minder = الحارس
Minders = الحرّاس
Mindful = حريص
Mindfully = بانتباه
Mindfulness = يقظة
Minding = التدبير
Mindless = طائش
Mindlessly = بغفلة
Mindlessness = غفلة
Minds = العقول
Mine = اللغم
Mined = منقّب
Minefield = حقل الألغام
Miner = عامل المنجم
Mineral = المعدن
Mineralize = معدن
Mineralized = ممعدن
Mineralizes = يمعدن
Mineralizing = التمعدن
Minerally = بشكل معدني
Mineralogical = متعلق بعلم المعادن
Mineralogically = متعلق بعلم المعادن
Mineralogies = علوم المعادن
Mineralogist = متخصص بالمعادن
Mineralogists = متخصصون بالمعادن
Mineralogy = علم المعادن
Minerals = المعادن
Miners = عمّال المناجم
Minerva = إلاهة الحكمة عند الرومان
Mines = ألغام
Minestrone = الشوربة
Minesweeper = كاسحة الألغام
Minesweepers = كاسحات الألغام
Ming = مينج
Mingle = إخلط
Mingled = مخلوط
Mingles = يخلط
Mingling = الخلط
Mini = الثوب القصير
Mini-Commander = القائد الصغير
Mini-cruiser = الطرّاد الصغير
Miniature = المصغر
Miniatures = المصغرون
Miniaturization = التصغير
Miniaturizations = التصغير
Miniaturize = صغّر
Miniaturized = مصغّر
Miniaturizes = يصغّر
Miniaturizing = التصغير
Minibike = دراجة صغيرة
Minicartridge = مخزن رصاص صغير
Minicomputer = الحاسبة المتوسّطة
Minicomputers = الحاسبات المتوسّطة
Minidress = الثوب القصير
Minidresses = الثياب القصيرة
Minified = مصغّر
Minifies = يصغّر
Minify = صغّر
Minifying = التصغير
Minim = القطرة
Minima = الحدود الدنيا
Minimal = أقل ما يمكن
Minimalist = الإصلاحي
Minimalists = الإصلاحيون
Minimally = بالحد الأدنى
Minimax = مينيماكس
Minimization = تحقيق الحدّ الأدنى
Minimizations = تحقيق الحدّ الأدنى
Minimize = قلّل
Minimized = مقلّل
Minimizer = شراع صغير
Minimizers = أشرعة صغيرة
Minimizes = يقلّل
Minimizing = التقليل
Minimum = الحدّ الأدنى
Minimums = الحدود الدنيا
Mining = التعدين
Minion = التابع
Minions = التوابع
Minis = الثياب القصيرة
Miniscule = الحرف الصغير
Miniskirt = الفستان القصير
Minister = الوزير
Ministered = خدم
Ministerial = وزاري
Ministerially = وزاريا
Ministering = يخدم
Ministers = الوزراء
Ministrant = خادم
Ministrants = خدم
Ministration = الخدمة
Ministrations = الخدمات
Ministries = وزارات
Ministry = وزارة
Miniver = فرو أبيض
Minix = مينيكس
Mink = ثعلب الماء
Minks = ثعالب الماء
Minneapolis = ميننيبوليس
Minnesota = مينيسوتا
Minnie = ميني
Minnow = البلمة
Minnows = البلم
Minoan = ذو علاقة بحضارة جزيرة اقريطش
Minor = قاصر
Minored = قاصر
Minoring = التخصص التشعيبي
Minorities = الأقلّيات
Minority = الأقلية
Minors = قاصرون
Minos = مينوس
Minot = مينوت
Minsk = منسك
Minsky = مينسكاي
Minster = الكاتدرائية
Minsters = الكاتدرائيات
Minstrel = المنشد
Minstrels = المنشدون
Minstrelsy = الأشعار الشعبية
Mint = النعناع
Mintage = سكّ العملة
Mintages = سك العملات
Minted = مسكوك
Minter = المخترع، صانع العملة المعدنية
Minting = سكّ النقود
Mints = النعناع
Minuend = المطروح منه
Minuends = المطروح منهم
Minuet = رقصة كلاسيكية
Minuets = رقصات كلاسيكية
Minus = ناقص
Minuscule = حرف صغير
Minuses = النواقص
Minute = دقيق
Minuted = مدوّن
Minutely = بدقة
Minuteman = المواطن الذي يحتاج لدقيقة فقط ليكون مستعداً للقتال
Minutemen = المواطنون الذي يحتاج لدقيقة فقط ليكون مستعداً للقتال
Minuteness = متسم بالاهتمام البالغ بالتفاصيل
Minuter = أدقّ
Minutes = الدقائق
Minutest = أدقّ
Minutiae = التفاصيل
Minuting = التدوين
Minx = المينكس
Miocene = متعلق بالعصر الثلثي الأوسط
