Montevideo = مونتيفديو
Montgomery = مونتغومري
Month = الشهر
Monthes = الشهر
Monthlies = المجلات الشهرية
Monthly = شهريا
Months = الشهور
Monticello = مونتايسلو
Montmartre = مونتمارتر
Montpelier = مونتبيلير
Montrachet = مونتراتشيت
Montreal = مونتريال
Montserrat = مونتسيرات
Monty = مونتي
Monument = النصب
Monumental = تذكاري
Monumentality = الأثريّة
Monumentally = بشكل تذكاري
Monuments = الأنصاب
Moo = اللعبة المشتركة
Mooch = إسرق
Mooched = مسروق
Mooches = يسرق
Mooching = السرقة
Mood = المزاج
Moodier = أكثر مزاجية
Moodiest = أكثر مزاجية
Moodily = مزاجيا
Moodiness = المزاجية
Moods = المزاج
Moody = مزاجي
Mooed = مخار
Mooing = الخور
Moon = القمر
Moonbeam = شعاع القمر
Mooned = هلالي
Mooney = شركة طائرات موني
Mooning = التّجوال
Moonlight = ضوء القمر
Moonlighted = أدّى عملاً إضافيًّا
Moonlighter = صاحب المهنتين
Moonlighting = العمل الإضافيّ
Moonlights = أضواء القمر
Moonlit = مقمر
Moons = الأقمار
Moonshine = ضوء القمر
Moonshiner = بائع الخمر الممنوع
Moonstone = سليكات الألمنيوم
Moonstruck = معتوه
Moonwalk = التمشّي على سطح القمر
Moony = هلالي
Moor = الأرض البور
Moorage = المرسى
Moore = مور
Moored = مربّط
Moorhen = دجاجة الماء
Mooring = التربّط
Moorings = مراسي السفن
Moorish = مغاربي
Moorland = الأرض البرية
Moorlands = الأراضي البرية
Moors = الأراضي البور
Moos = الخوار
Moose = الأيّل
Moot = موضع نقاش
Mooted = مقترح
Mop = الممسحة
Mope = الإكتئاب
Moped = الدراجة
Moper = المكتئب
Mopes = الإكتئاب
Moping = الإكتآب
Mopped = منظّف
Moppet = اللعبة
Moppets = اللعب
Mopping = التنظيف
Mops = المماسح
Moraine = كتلة من الصخور والأحجار
Moral = المغزى
Morale = الروح المعنوية
Morales = الروح المعنوية
Moralist = الفيلسوف الأخلاقي
Moralistic = أخلاقي
Moralistically = بتزمّت
Moralists = الفلاسفة الأخلاقيون
Moralities = المبادىء الأخلاقية
Morality = المبادىء الأخلاقية
Moralization = التفسير الأخلاقي
Moralize = عظ
Moralized = موعوظ
Moralizer = الواعظ
Moralizes = يعظ
Moralizing = الوعظ
Morally = أدبيا
Morals = الأخلاق
Moran = موران
Morass = المستنقع
Morasses = المستنقعات
Moratorium = التأجيل
Moratoriums = التعليقات
Moravia = مورافيا
Moravian = مورافي
Moray = الموراي - ثعبان الماء
Morbid = سقيم
Morbidity = المرضية
Morbidly = بشكل سقيم
Morbidness = المرضيّة
Mordancy = السخرية الجارحة
Mordant = جارح
Mordantly = بشكل جارح
More = أكثر
Morehouse = مورهاوس
Morel = نبات عش الغراب
Moreland = موريلاند
Moreover = علاوة على ذلك
Mores = الأعراف
Moresby = موريسبي
Morgan = مورغان
Morgen = مورغن
Morgue = المشرحة
Morgues = المشارح
Moriarty = موريارتاي
Moribund = محتضر
Moribundity = الاحتضار
Moribundly = بشكل محتضر
Morion = المريون: خوذة معدن ذات عرف
Morley = مورلي
Mormon = المرمون
Morn = الصباح
Morning = صباح
Mornings = أوقات الصّباح
Moroccan = المغربي
Morocco = المغرب
Moron = البليد
Moronic = بليد
Moronically = بغباوة
Morons = البلداء
Morose = كئيب
Morosely = بشكل كئيب
Moroseness = الكآبة
Morpheme = المقطع
Morphemic = مورفيمي
Morphia = المورفين
Morphine = المورفين
Morphines = المورفين
Morphologic = صرفي
Morphological = صرفي
Morphologically = بشكل صرفي
Morphology = علم الصرف
Morphophonemic = شكليّ صوتيّ
Morphophonemics = التباين في اللفظ
Morrill = موريل
Morris = موريس :: رقصة موريس الإنجليزية
Morrison = موريسون
Morrissey = موريسسي
Morristown = موريستاون
Morrow = الغدّ
Morse = مورس
Morsel = اللقمة
Morsels = اللقم
Mort = كمية كبيرة
Mortal = الإنسان
Mortalities = الموت
Mortality = الفناء
Mortally = بشدّة
Mortals = البشر
Mortar = الهاون
Mortarboard = لوح لنقل الإسمنت
Mortared = مملّط
Mortaring = التمليط
Mortars = الهاونات
Mortem = مورتيم
Mortgage = القرض العقاري
Mortgaged = مرهون
Mortgagee = المرتهن
Mortgagees = المرتهنون
Mortgager = المموّل
Mortgagers = المموّلون
Mortgages = القروض العقارية
Mortgaging = الرهن
Mortgagor = مستدين القرض العقاري
Mortgagors = مستدينو القروض العقارية
Mortician = مجهز الجنازات
Morticians = مجهزو الجنازات
Mortification = الإهانة
Mortifications = الإهانات
Mortified = مكبوح
Mortifier = المسبب للحرب، الكابح
Mortifies = يكبح
Mortify = إكبح
Mortifying = الكبح
Mortifyingly = بخزي
Mortimer = مورتيمر - متمرّد ويلزيّ و عشيق زوجة إدوارد الثاني
Mortis = الموت
Mortise = الحفرة
Mortised = محفور
Mortises = الحفر
Morton = مورتن
Mortuaries = مستودعات الجثث
Mortuary = مستودع الجثث
Mos = أوكسيد المعدن الشبه موصّل
Mosaic = الفسيفساء
Mosaics = الفسيفساء
Moscone = موسكون
Moscow = موسكو
Mose = موس
Moser = موسر
Moses = موسى
Mosey = إمش بتثاقل
Moseyed = مشى بتثاقل
Moseying = مشي بتثاقل
Moseys = يمشي بتثاقل
Moslem = مسلم
Moslems = المسلمون
Mosque = المسجد
Mosques = المساجد
Mosquito = البعوضة
Mosquitoes = البعوض
Mosquitos = البعوضة
Moss = الطّحلب
Mossberg = ماركة تجارية لشركة بنادق
Mosses = الأشنات
Mossier = مطحلب
Mossiest = مطحلب
Mossy = مطحلب
Most = أكثر
Mostfreq = المتكررة
Mostly = في الغالب
Mot = الفحص السنوي
Mote = الذرة
Motel = الفندق
Motels = الفنادق
Motet = الترتيل
Moth = العثّ
Mothball = النّفتالين
Mothballed = جمّد، أعفى من الخدمة
Mothballing = التجميد، الإعفاء من الخدمة
Mothballs = النّفتالين
Mother = الأمّ
Motherboard = لوحة الذاكرة
Motherboards = الواح الذاكرة
Mothered = مربّى
Motherhood = الأمومة
Mothering = التربية
Motherland = الوطن
Motherless = بلا أم
Motherliness = الأمومة
Motherly = بحنان
Mothers = الأمهات
Mothes = موثيس
Moths = العثّ
Motif = الموضوع
Motifs = المواضيع
Motile = متحرّك
Motion = الحركة
Motional = متحرك
Motioned = أشير
Motioner = المحرّك
Motioning = الإشارة
Motionless = ساكن
Motionlessly = بشكل ساكن
Motionlessness = إنعدام الحركة
Motions = الحركات
Motivate = حفّز
Motivated = مدفوع
Motivates = يحفّز
Motivating = التحفيز
Motivation = الحافز
Motivational = تحفيزي
Motivationally = بشكل محفّز
Motivations = الحوافز
Motivative = موتيفاتيف
Motivator = المحفّز
Motive = الدافع
Motived = حفّز
Motively = بشكل حافز
Motives = الدوافع
Motiving = التحفيز
Motley = ثوب المهرج
Motor = المحرّك
Motorbike = الدراجة البخارية
Motorboat = قارب بمحرّك
Motorcade = موكب السيارات
Motorcar = سيارة
Motorcars = سيارات
Motorcycle = الدراجة البخارية
Motorcycles = الدراجات البخارية
Motorcyclist = سائق الموتوسيكل
Motored = سافر
Motoring = السياقة
Motorist = السائق
Motorists = السوّاق
Motorization = تزويد بالمحرّك
Motorize = مكنن
Motorized = ذو محرّك
Motorizes = يمكنن
Motorizing = المكننة
Motorman = السّائق
Motormen = السّائقون
Motorola = موتورولا
