Atrociousness = الرّداءة
Atrocities = البشاعات
Atrocity = البشاعة
Atrophic = ضامر
Atrophied = ضمر
Atrophies = الضّمور
Atrophy = الضّمور
Atrophying = الضّمور
Atropine = الأتروبين
Atropos = أتْروبُسْ
Attach = ألحق
Attachable = معرّض للمصادرة
Attache = الملحق
Attached = ألحق
Attacher = مُلحق
Attachers = مُلحقون
Attaches = الملحقون
Attaching = التّثبيت
Attachment = الحبّ
Attachments = الحبّ
Attack = الهجوم
Attackable = معرّض للهجوم
Attacked = هاجم
Attacker = المهاجم
Attackers = المهاجمون
Attacking = المهاجمة
Attacks = الهجمات
Attain = يحرز
Attainability = التّحقيق
Attainable = ممكن إحرازه
Attainableness = إمكانية الإحراز
Attainder = حكم بمصادرة ممتلكات
Attained = أحرز
Attainer = مُحرِز
Attainers = محرزون
Attaining = النّيل
Attainment = التّحقيق
Attainments = القدرات
Attains = ينال
Attaint = دن
Attainted = أدان
Attainting = الإدانة
Attaints = يدين
Attar = عطر الورد
Attars = عطور الورد
Attempt = المحاولة
Attemptable = قابل للمحاولة
Attempted = مدبّر
Attempter = محاول
Attempters = محاولون
Attempting = المحاولة
Attempts = المحاولات
Attend = احضر
Attendance = الحاضرون
Attendances = الحاضرون
Attendant = الخادم
Attendants = الخدم
Attended = حضر
Attendee = حاضر
Attendees = الحاضرون
Attender = حاضر
Attenders = حاضرون
Attending = الحضور
Attends = يحضر
Attention = الانتباه
Attentional = سيكلوجية الإنتباه
Attentions = الانتباه
Attentive = منتبه
Attentively = بانتباه
Attentiveness = الانتباه
Attenuate = اضعف
Attenuated = أضعف
Attenuates = يضعف
Attenuating = الإضعاف
Attenuation = التّخفيف
Attenuations = التّخفيف
Attenuator = المخفّف
Attenuators = المخفّفات
Attest = دلّ
Attestation = الشّهادة
Attestations = الشّهادات
Attested = دلّ
Attester = الشاهد
Attesting = الدّلالة
Attests = يدلّ
Attic = السّندرة
Attica = أتيكا
Attics = السّندرات
Attire = الملابس
Attired = مرتدي ثياب
Attires = الملابس
Attiring = الارتداء
Attitude = الموقف
Attitudes = المواقف
Attitudinal = اتّجاهيّ
Attitudinally = عليّ نحو اتّجاهيّ
Attitudinize = تصنّع
Attitudinized = تصنّع
Attitudinizes = يتصنّع
Attitudinizing = التّصنّع
Attorney = المحامي
Attorneys = المحامون
Attorneyship = محاماة
Attract = اجذب
Attractability = الجاذبية
Attractable = منجذب
Attracted = جذب
Attracting = الجذب
Attraction = الانجذاب
Attractions = الانجذاب
Attractive = جذّاب
Attractively = بشكل جذّاب
Attractiveness = الجاذبيّة
Attractor = الجذّاب
Attractors = الجذّابون
Attracts = يجذب
Attributable = منسوب
Attribute = الصّفة
Attributed = نسب
Attributer = المسبّب
Attributes = الصّفات
Attributing = النّسب
Attribution = النّسب
Attributional = نسبيّ
Attributions = الصّفات
Attributive = مسند
Attributively = قبل الاسم
Attrition = الاستنزاف
Attritional = متآكل
Attritions = الإستنزافات
Attune = أقلم
Attuned = معتاد
Attunes = يؤقلم
Attuning = التّأقلم
Atwater = أتواتر
Atwood = أتوُد
Atypic = شاذّ
Atypical = شاذّ
Atypically = بشكل شاذّ
Au pair = الإجنبي المقيم مع عائلة مقابل القيام ببعض الأعمال المنزلية
Auberge = الحانة
Aubrey = أوبري
Auburn = بنّيّ محمرّ
Auckland = أوكلاند
Auction = المزاد
Auctioned = باع بالمزاد العلنيّ
Auctioneer = بائع المزاد
Auctioneers = باعة المزاد
Auctioning = بيع بالمزاد العلنيّ
Auctions = المزادات
Audacious = جريء
Audaciously = بجراءة
Audaciousness = الجرأة
Audacity = الجرأة
Audibilities = السّمعيّات
Audibility = السّمع
Audible = مسموع
Audibly = بشكل مسموع
Audience = الجمهور
Audiences = الجماهير
Audio = سمعيّ
Audio-visual = سمعيّ بصريّ
Audiofrequency = التّردّدات السّمعيّة
Audiogram = تخطيط سمعيّ
Audiograms = تخطيط سمعيّ
Audiological = متعلق بعلم السّمع
Audiologist = متخصص السمعيّات
Audiologists = متخصصوا السمعيات
Audiology = علم السمع
Audiometer = مقياس قوّة السّمع
Audiometers = مقاييس قوّة السّمع
Audiometric = قيّاس لقوّة السّمع
Audiometry = قِياس قوّة السّمع
Audiotape = شريط التّسجيل
Audiovisual = سمعيّ بصريّ
Audiovisuals = سمعيّة بصريّة
Audit = يراجع
Audited = راجع
Auditing = المراجعة
Audition = الاختبار
Auditioned = أدّى اختبارًا
Auditioning = أداء اختبار
Auditions = الاختبارات
Auditive = سمعيّ
Auditor = المراجع
Auditorium = القاعة
Auditoriums = القاعات
Auditors = المحاسبون
Auditory = سمعيّ
Audits = مراجعات الحسابات
Audrey = أودري
Audubon = أودوبون
Auerbach = أويرباتش
Auf = أوف
Aug = أغسطس
Augean = قذر
Augend = المجموع عليه
Auger = الخرّامة
Augers = الخرّامات
Aught = أيّ شيء
Augite = الأوجايت
Augment = يزداد
Augmentable = قابل للازدياد
Augmentation = ازدياد
Augmentations = ازديادات
Augmented = مَزيد
Augmenter = مُزداد
Augmenting = الازدياد
Augments = يزداد
Augur = تنبّأ
Augured = تنبّأ
Auguries = النّذيرة
Augurs = يتنبّأ
Augury = النّذير
August = أغسطس
Augusta = أوجستا
Augustan = أغسطسيّ
Augustine = أوغسطين
Augustly = بشكل مهيب
Augustness = الهَيْبة
Augusts = أشهر آب/أغسطس
Augustus = أوغسطس
Auk = الأوك
Aunt = العمّة
Auntie = العمّة
Auntly = أونتلي
Aunts = العمّات
Aura = الهالة
Aurae = الهالات
Aural = سمعيّ
Aurally = سمعيًّا
Auraly = بشكل أذني
Auras = الهالات
Aureate = ذهبيّ
Aurelius = أوريليوس
Aureole = الهالة
Aureoles = الهالات
Aureomycin = الأوريومايسين
Auric = ذهبيّ
Auricle = الأذين
Auricles = الأذين
Auricular = سمعيّ
Auriferous = ذهبيّ
Auriga = الذو الأعنّة
Aurochs = الثّور
Aurora = الفجر
Auroral = فجري
Aus = الجيش الأمريكي
Auschwitz = أوسكويتز
Auscultate = افحص
Auscultated = فحص
Auscultates = يفحص
Auscultating = الفحص
Auscultation = التّسمّع
Auscultations = التّسمّع
Auspice = الطالع
Auspices = رعاية
Auspicious = مبشّر
Auspiciously = بشكل مبشّر
Auspiciousness = السعادة
Austenite = الأوستينيت
Austere = بسيط
Austerely = بشكل بسيط
Austereness = البساطة
Austerity = البساطة
Austin = أوستن
Austral = جنوبيّ
Australia = أستراليا
Australian = الأستراليّ
Australians = الأستراليّون
Australis = جنوبيّ
Australize = يميل إلى الجنوب
Austria = النّمسا
Austrian = النّمساويّ
Austrians = النّمساويّون
Autarchic = ذو سيادة مطلقة
Autarchy = الاستبداد
Authentic = أصليّ
Authentically = بشكل أصليّ
Authenticate = صدّق
Authenticated = صدّق
Authenticates = يصدّق
Authenticating = التّصديق
Authentication = التّوثيق
Authentications = التّوثيقات
Authenticator = الموثّق
Authenticators = الموثّقون
Authenticity = الأصالة
Author = المؤلّف
Authored = ألّف
Authoress = المؤلّفة
Authoresses = المؤلّفات
Authoring = التأليف
Authoritarian = المتسلّط
Authoritarianism = التّسلّط
Authoritarianisms = الإستبدادية
Authoritative = موضع ثقة
Authoritatively = بشكل متسلّط
Authoritativeness = التسلّط
Authorities = المسئولون
