Pronoun = الضمير
Pronounce = إلفظ
Pronounceable = واضح
Pronounced = واضح
Pronouncedly = بشكل واضح
Pronouncement = التصريح
Pronouncements = التصريحات
Pronouncer = النّاطق
Pronounces = يلفظ
Pronouncing = اللفظ
Pronouns = الضمائر
Pronto = حالا
Pronunciation = التلفظ
Pronunciations = التلفظ
Proof = البرهان
Proofed = أصبح مقاوما لـ
Proofer = تصحيحي
Proofing = المقاومة للماء او الصدأ الخ
Proofread = صحّح
Proofreader = المصحّح
Proofreading = التصحيح
Proofreads = يصحّح
Proofs = البراهين
Prop = الدعامة
Propaganda = الدعاية
Propagandist = الداعية
Propagandistic = دعائي
Propagandistically = بصورة دعائيّة
Propagandists = الدعاة
Propagandize = حاول إقناع
Propagandized = حوول إقناع
Propagandizing = محاولة إقناع
Propagate = كاثر
Propagated = مكاثر
Propagates = يكاثر
Propagating = المكاثرة
Propagation = التوليد
Propagations = التوليدات
Propagative = إنتشاري
Propagator = المروّج
Propane = البروبان
Propel = إدفع
Propellant = دافع
Propellants = الدوافع
Propelled = مدفوع
Propellent = الدافع
Propeller = المروحة
Propellers = المراوح
Propelling = الدفع
Propels = يدفع
Propensities = النزعات
Propensity = النزعة
Proper = صحيح
Properly = بشكل صحيح
Properness = المناسَبة، التصرّفات المناسِبة
Propertied = مالك
Properties = الملكيات
Property = الملكية
Prophecies = النبوءات
Prophecy = النبوءة
Prophesied = متنبّأ
Prophesier = الرسول الربّاني
Prophesies = يتنبّأ
Prophesy = تنبّأ
Prophesying = التنبّأ
Prophet = النبي
Prophetess = النبية
Prophetesses = النبيات
Prophetic = نبوي
Prophetical = نبوي
Prophetically = بشكل نبوي
Prophets = الأنبياء
Prophylactic = وقائي
Prophylactically = بشكل وقائيّ
Prophylaxis = الوقاية
Propinquities = القرابات
Propinquity = القرابة
Propionate = بروبيونيت - ملح حمض البروبيونيك
Propitiate = إسترض
Propitiated = مسترضى
Propitiates = يسترضى
Propitiating = الإسترضاء
Propitiation = الإستعطاف
Propitiatory = إسترضائي
Propitious = مواتي
Propitiously = بشكل مواتي
Propitiousness = التبشير
Proponent = المقترح
Proponents = المقترحون
Proportion = النسبة
Proportional = نسبي
Proportionality = التّناسب
Proportionally = بشكل متناسب
Proportionate = متكافئ
Proportionated = متناسب
Proportionately = بشكل متناسب
Proportionates = يتناسب
Proportionating = التناسب
Proportioned = متناسب
Proportioner = المنسّب
Proportioning = التناسب
Proportionment = التّناسب
Proportions = الأبعاد
Proposal = الإقتراح
Proposals = الإقتراحات
Propose = إقترح
Proposed = مقترح
Proposer = المقترح، مقدم الاقتراح
Proposers = المقترحون، مقدمو الاقتراح
Proposes = يقترح
Proposing = الإقتراح
Proposition = المقترح
Propositional = إقتراحي
Propositionally = بشكل إقتراحي
Propositioned = راود
Propositioning = المراودة
Propositions = المقترحات
Propound = إقترح
Propounded = مقترح
Propounder = الشخص المقترح
Propounding = الإقتراح
Propounds = يقترح
Propped = مسند
Propping = الإسناد
Proprietaries = مالكو الحقوق
Proprietary = الملكية
Proprietor = المالك
Proprietors = المالكون
Proprietorship = الملكية
Proprietorships = الملكية
Propriety = الصلاحية
Proprioception = الحركة اللا إرادية للجسم وأعضاءه
Proprioceptive = ذاتي التحفيز
Props = الدعائم
Propulsion = الدفع
Propulsions = الدفع
Propulsive = دافع
Propyl = بروبيل - مركب عضوي
Propylene = البروبيلين - غاز قابل للاشتعال
Propyne = بروبين
Proratable = قابل للتوزيع
Prorate = وزّع
Prorated = موزّع
Prorates = يوزّع
Prorating = التوزيع
Proration = التوزيع
Prorogue = أجّل
Prorogued = مؤجّل
Prorogues = يؤجّل
Proroguing = التأجيل
Pros = المحترفون
Prosaic = ممل
Prosaically = بملل
Prosaicness = الملل
Proscenia = مقدمات المسارح
Proscenium = مقدمة المسرح
Prosceniums = مقدمة المسرح
Proscribe = حرّم
Proscribed = محرّم
Proscriber = المدين، المانع
Proscribes = يحرّم
Proscribing = التحريم
Proscription = التحريم
Proscriptive = تحريمي
Proscriptively = بشكل تحريمي
Prose = النثر
Prosecute = حاكم
Prosecuted = محاكم
Prosecutes = يحاكم
Prosecuting = المحاكمة
Prosecution = الإدّعاء
Prosecutions = المحاكمات
Prosecutor = المدّعي
Prosecutors = المدّعون
Prosed = كتب نثر
Proselyte = المرتدّ
Proselyted = محوّل
Proselytes = المرتدّون
Proselyting = التحويل
Proselytism = الاهتداء
Proselytize = حوّل
Proselytized = محوّل
Proselytizer = الدّاعية
Proselytizers = الدّعاة
Proselytizes = يحوّل
Proselytizing = التحويل
Proser = النّاثر
Proserpine = بروسيربن - ابنة سيريز التي أصبحت ربّة عالم الجريمة. الأساطير الرومانية
Proses = النثر
Prosier = أكثر إسهابا
Prosiest = أكثر إسهابا
Prosing = كتابة النثر
Prosodic = عروضيّ
Prosodies = علم العروض
Prosody = علم العروض
Prosopopoeia = التّشخيص
Prospect = الفرصة
Prospected = منقّب
Prospecting = التنقيب
Prospection = التنقيب
Prospections = التنقيب
Prospective = متوقّع
Prospectively = مستقبليا
Prospectiveness = التّرقّب
Prospector = المنقّب
Prospectors = المنقّبون
Prospects = الفرص
Prospectus = الدليل
Prosper = إنجح
Prospered = ناجح
Prospering = النجاح
Prosperities = الإزدهار
Prosperity = الإزدهار
Prosperous = ناجح
Prosperously = بشكل ناجح
Prosperousness = الإزدهار
Prospers = ينجح
Prostate = البروستات
Prostheses = الطّرف الصّناعي - يد، رجل، الخ
Prosthesis = البديل
Prosthetic = بديلي
Prosthetically = صناعي - يد، رجل، الخ
Prosthetics = علم الأعضاء الإصطناعية
Prostitute = المومس
Prostituted = مارست البغاء
Prostitutes = المومسات
Prostituting = البغاء
Prostitution = الدعارة
Prostrate = ساجد
Prostrated = منطرح
Prostrates = ينطرح
Prostrating = الإنطراح
Prostration = الإنهيار
Prosy = مسهب
Protactinium = بروتكتينيوم - عنصر معدنيّ مشعّ
Protagonist = النصير
Protagonists = الأنصار
Protean = متقلّب
Protease = الإنزيم البروتيني
Proteases = الإنزيمات البروتينية
Protect = إحم
Protected = محمي
Protectedly = بشكل محمي
Protecting = الحماية
Protection = الحماية
Protectionism = الحماية
Protectionist = نصير الحماية
Protections = الحماية
Protective = وقائي
Protectively = بشكل وقائي
Protectiveness = الحماية
Protector = الحامي
Protectorate = المحمية
Protectors = الحماة
Protects = يحمي
Protege = المحمي
Protegee = إمرأة تحت الحماية
Proteges = المحميون
Protein = البروتين
Proteins = البروتين
Proteolysis = التّحلّل البروتينيّ
Proteolytic = متعلق بـ التّحلّل البروتينيّ
Protest = الإحتجاج
Protestant = البروتستانتيّ
Protestantism = البروتستانتية
Protestants = البروتستانتيون
Protestation = التأكيد
Protestations = التأكيدات
Protested = محتجّ
Protester = المحتجّ
Protesters = المحتجّون
Protesting = الإحتجاج
Protestingly = إحتجاجا
Protests = الإحتجاجات
Prothonotary = الموظّف الرّئيسيّ
Protocol = النظام
Protocols = الإتفاقيات
Proton = البروتون
Protons = البروتونات
Protophyta = نبات احادي الخلية
Protoplasm = البروتوبلازم
Protoplasmic = بروتوبلازمي
Prototypal = نموذجي
Prototype = النموذج
Prototypes = النماذج
Prototypic = نموذجي
Prototypical = نموذجي
Prototypically = بشكل نموذجي
Prototyping = نموذجي
Protozoa = البروتوزوا
Protozoan = بروتوزوي
Protract = أطل
Protracted = مطوّل
Protractile = قابل للتمدد
Protracting = الإطالة
Protraction = الإطالة
Protractive = طويل الأمد
Protractor = المنقلة
Protracts = يطيل
Protrude = أبرز
