Quasars = النجوم الفلكية البعيدة
Quash = أسقط
Quashed = مسقط
Quashes = يسقط
Quashing = الإسقاط
Quasi = شبه
Quasimodo = يوم الأحد الذي يأتي مباشرة بعد عيد الفصح
Quasiparticle = مركّب يتشابه في سلوكه لجزيء واحد
Quasiperiodic = شبه دوري
Quaternaries = العدد أربعة، الترتيب الرابع
Quaternary = رباعي
Quatrain = الرباعية
Quaver = الصوت المتهدج
Quavered = مرتجف
Quavering = الإرتجاف
Quaveringly = بارتعاش
Quavers = الأصوات المتهدجة
Quavery = مرتعش
Quay = رصيف الميناء
Quays = أرصفة الميناء
Que = إختصار إسم مدينة كوبيك الكندية
Queasier = مغثي
Queasiest = مغثي
Queasily = بشكل مضطرب
Queasiness = الغثيان
Queasinesses = الغثيان
Queasy = مغثي
Quebec = كويبيك
Queen = الملكة
Queenly = ملكي
Queens = الملكات
Queer = اللوطي
Queerer = أكثر شذوذا
Queerest = أكثر شذوذا
Queerly = بشكل شاذ
Queerness = الغرابة
Queers = الشواذ
Queeze = كويز - نوع من الطيور، غصن شجرة
Quell = إقمع
Quelled = مقموع
Queller = القامع
Quelling = القمع
Quells = يقمع
Quench = إرو
Quenchable = قابل للإخماد
Quenched = مروي
Quencher = مخمد النار، قامع الشغب، مطفيء الضمأ
Quenches = يروي
Quenching = الرواية
Quenchless = لا يطفأ، لا يقمع
Queried = مسؤول
Querier = سائل السؤال
Queries = الإستفسارات
Querulous = متشكي
Querulously = بتشكي دائم
Querulousness = التشكّي
Query = الإستفسار
Query-reply = إجابة إستفسار
Querying = السؤال
Queryingly = بتساؤل
Quest = المسعى
Quested = مبحوث
Quester = الباحث
Questing = البحث
Question = السؤال
Questionability = الشّك
Questionable = مشكوك فيه
Questionableness = الشّك
Questionably = بتساؤل
Questioned = مشكوك ب
Questioner = المستجوب
Questioners = المستجوبون
Questioning = الإستجواب
Questioningly = بتساؤل
Questionings = الإستجواب
Questionless = مؤكّد
Questionnaire = الإستفتاء
Questionnaires = الإستفتاءات
Questions = الأسئلة
Quests = المساعي
Quetzal = الكوازال
Queue = الطابور
Queued = اصطفّ، مُصْطَفّ
Queueing = تشكيل طابور
Queuer = المصطف في الطابور
Queuers = المصطفون في الطابور
Queues = الطوابير
Queuing = الإنتظار في الصف
Quezon = كويزون - إقليم في الفلبّين
Quibble = المراوغة
Quibbled = مراوغ
Quibbler = المراوغ
Quibbles = المراوغات
Quibbling = المراوغة
Quiche = الكيش - فطيرة
Quiches = فطائر الكيش
Quick = بسرعة
Quick-break = الإستراحة السريعة
Quicken = سرّع
Quickened = مسرّع
Quickener = المسرّع، المحيي، المشوّق
Quickening = التسريع
Quickens = يسرّع
Quicker = أسرع
Quickest = أسرع
Quickie = القصة المختصرة
Quickies = القصص المختصرة
Quicklime = الجير الحيّ
Quickly = بسرعة
Quickness = الفطنة
Quicknesses = الفطنة
QuickPrint = طبع سريع
Quicksand = الرمال المتحركة
Quicksands = الرمال المتحركة
Quicksilver = الزئبق
Quickstep = رقصة الفوكستروت
Quicksteps = رقصات الفوكستروت
Quid = الجنيه
Quiesce = يصمت
Quiescence = السكون
Quiescent = خامد
Quiescently = بشكل خامد
Quiet = الهدوء
Quieted = أسكت
Quieten = هدّئ
Quietened = مهدّأ
Quietening = التهدئة
Quietens = يهدّئ
Quieter = أهدأ
Quietest = أهدأ
Quieting = الإسكات
Quietly = بشكل هادئ
Quietness = الهدوء
Quiets = الهدوء
Quietude = الهدوء
Quietus = الهمود
Quill = الريشة
Quilling = اللفّ
Quills = الريشات
Quillwort = كويلوورت - نبات
Quilt = اللحاف
Quilted = مبطّن
Quilter = صانع اللحاف أو البطانة
Quilting = خياطة اللحف
Quilts = اللحف
Quin = أحد خمس توائم
Quince = السفرجلة
Quinces = السفرجل
Quincy = كوينسي
Quinine = الكينين
Quinn = كوين
Quinquennial = خمس سنوات
Quinquennially = بشكل خمس سنوات
Quinsy = الخناق
Quint = التّوأم من خمس توائم
Quintal = القنطار
Quintals = القناطير
Quintessence = الجوهر
Quintessences = الجواهر
Quintessential = مثالي
Quintessentially = بشكل مثالي
Quintet = الخماسي
Quintets = الخماسيات
Quintic = من الدرجة الخامسة
Quintillion = 1,000,000,000,000,000,000
Quintillionth = 0.000,000,000,000,000,001
Quints = خمس توائم
Quintuple = خمس أضعاف
Quintupled = مخمّس
Quintuples = يخمّس
Quintuplet = خمس توائم
Quintupling = التخميس
Quintus = كوينتس
Quip = المزحة
Quipped = قيل بطريقة مازحة
Quipping = قول بطريقة مازحة
Quips = المزح
Quire = الملزمة
Quirinal = كويرينال - أحد  التلال السبعة في روما القديمة
Quirk = المراوغة
Quirkier = أكثر إلتواء
Quirkiest = أكثر إلتواء
Quirkily = بشكل غريب
Quirkiness = الغرابة
Quirks = المراوغات
Quirky = ملتوي
Quirt = إجلد
Quisling = الخائن
Quit = متحرر
Quite = تماما
Quito = كويتو
Quits = يترك
Quittance = المخالصة
Quittances = المخالصات
Quitted = متروك
Quitter = الانهزاميّ
Quitters = الانهزاميّون
Quitting = الترك
Quiver = الرعشة
Quivered = مرتجف
Quivering = الإرتجاف
Quiveringly = بارتعاش
Quivers = الرعشات
Quixote = دون كاشيوت - بطل الواية التي تحمل إسمه
Quixotic = خيالي
Quixotically = بشهامة
Quiz = الإختبار
Quizzed = ممتحن
Quizzes = الإختبارات
Quizzical = متسائل
Quizzically = بتساؤل
Quizzing = السؤال
Quo = كو
Quod = السجن
Quoit = الحلقة
Quondam = سابق
Quonset = كوونسيت - ماركة تجارية لأكواخ متنقلة
Quorum = النصاب
Quota = الحصة
Quotable = مقتبس
Quotas = الحصص
Quotation = التقدير
Quotations = التقديرات
Quote = الإقتباس
Quoted = مقتبس
Quotes = الإقتباسات
Quoth = قل
Quotidian = يومي
Quotient = خارج القسمة
Quotients = خوارج القسمة
Quoting = الإقتباس
Quran = القرآن - الكتاب المقدّس عند المسلمين
R = آر - الحرف الثامن عشر في اللغة الإنجليزية
R&D = البحث و التطوير
Ra =  عنصر الراديوم
Rabat = الرباط
Rabbet = إحفر
Rabbi = الحبر
Rabbinic = رباني
Rabbinical = رباني
Rabbinically = ربانيا
Rabbis = الأحبار
Rabbit = الأرنب
Rabbit fever = حمّى الأرنب
Rabbited = ثرثر
Rabbiter = صياد الأرانب
Rabbiting = الثرثرة
Rabbits = الأرانب
Rabble = الرعاع
Rabbled = مثار
Rabbler = قضيب معدني يستعمل في التعدين
Rabbles = الرعاع
Rabbling = الثورة
Rabid = متطرّف
Rabidity = الغضب
Rabidly = بشكل متطرّف
Rabidness = الغضب
Rabies = داء الكلب
Rabin = رابين
Raccoon = الراكون
Raccoons = حيوانات الراكون
Race = الجنس
Racecourse = الحلبة
Raced = متسابق
Racehorse = حصان السباق
Racehorses = أحصنة السباق
Racer = المتسابق
Racers = المسابقون
Races = الأجناس
Racetrack = مضمار السباق
Racetracker = المتردّد على حلبة السباق
Raceway = القناة، مجرى السباق
Rachel = رايتشل
Rachmaninoff = راتشمانينوف
Racial = عرقي
Racialism = التميز العنصري
Racialist = عنصري
Racially = عرقيا
Racier = أكثر حيوية
Raciest = أكثر حيوية
Racily = بشكل حادّ
Racine = راسين
Raciness = الذوق المميز
Racing = السباق
Racism = التمييز العنصري
Racist = العنصري
Racists = العنصريون
Rack = الرفّ
Racked = مؤلم
Racker = مصفف كرات البلياردو
Racket = المضرب
Racketeer = المبتز
Racketeering = الإبتزاز
Racketeers = المبتزون
Rackets = المضارب
Rackety = مزعج
Racking = الإجهاد
Racks = الرفوف
Rackspace = راك سبيس
Racoon = الراكون
