Rein = الزمام
Reincarnate = منسوخ
Reincarnated = خلق ثانية
Reincarnates = يخلق ثانية
Reincarnating = خلق ثانية
Reincarnation = التناسخ
Reincorporate = أعد دمج
Reincorporated = معاد دمج
Reincorporates = يعيد دمج
Reincorporating = إعادة دمج
Reincorporation = إعادة إندماج
Reindeer = الرنّة
Reinduce = أقنع
Reinduced = مقنع
Reinduces = يقنع
Reinducing = الإقناع
Reined = موجّه
Reinfect = أعد ثانية
Reinfected = معدى ثانية
Reinfecting = إعداء ثانية
Reinfects = يعدي ثانية
Reinflame = إعادة تلهب
Reinflamed = ملتهب ثانية
Reinflaming = إعادة إلهاب
Reinforce = عزّز
Reinforced = مدعوم
Reinforcement = التعزيز
Reinforcements = التعزيزات
Reinforcer = المؤكّد
Reinforces = يعزّز
Reinforcing = التعزيز
Reinform = أبلغ مجدّدا
Reinfuse = أفعم
Reinhard = راينارد
Reinhardt = رينهاردت
Reinhold = راينولد
Reining = التوجيه
Reinitialization = إعادة تهيئة
Reinitialize = إعادة تشغّل
Reinitialized = إعادة شغّلت
Reinitializing = إعادة تشغيل
Reinoculate = أعد تلقيح
Reinoculated = معاد تلقيح
Reinoculates = يعيد تلقيح
Reinoculating = إعادة تلقيح
Reins = الأزمّة
Reinsert = أعد إدخال
Reinserted = معاد إدخال
Reinserting = إعادة إدخال
Reinsertion = إعادة إدخال
Reinserts = يعيد إدخال
Reinspect = أعد تفتيش
Reinspected = معاد تفتيش
Reinspecting = إعادة تفتيش
Reinspects = يعيد تفتيش
Reinstall = ركّب ثانية
Reinstallation = إعادة تركيب
Reinstalled = مركّب ثانية
Reinstaller = إعادة مركّب
Reinstalling = تركيب ثانية
Reinstalls = يركّب ثانية
Reinstate = أعد تنصيب
Reinstated = معاد تنصيب
Reinstatement = الإرجاع
Reinstates = يعيد تنصيب
Reinstating = إعادة تنصيب
Reinstitution = إعادة مؤسسة
Reinstruct = أوعز إليه
Reinstructed = موعز إلى
Reinstructing = الإيعاز إلى
Reinstructs = يوعز إليه
Reinsurance = إعادة التّأمين
Reinsure = جدّد تأمين
Reinsured = مجدّد تأمين
Reinsures = يجدّد تأمين
Reinsuring = تجديد تأمين
Reintegrate = تكامل
Reintegrated = متكامل
Reintegrates = يتكامل
Reintegrating = التكامل
Reintegration = إعادة تكامل
Reinter = أعد دفن
Reinterpret = أعد ترجمة
Reinterpretation = إعادة تفسير
Reinterpreted = معاد ترجمة
Reinterpreting = إعادة ترجمة
Reinterprets = يعيد ترجمة
Reinterview = إعادة مقابلة
Reinterviewed = مقابل ثانية
Reintroduce = أعد تقديم
Reintroduced = معاد تقديم
Reintroduces = يعيد تقديم
Reintroducing = إعادة تقديم
Reintroduction = الأعادة
Reinvent = أعد إختراع
Reinvented = معاد إختراع
Reinventing = إعادة إختراع
Reinvention = إعادة إختراع
Reinvents = يعيد إختراع
Reinvest = أعد إستثمار
Reinvested = معاد إستثمار
Reinvestigate = أعد تحقيق
Reinvestigated = معاد تحقيق
Reinvestigates = يعيد تحقيق
Reinvestigating = إعادة تحقيق
Reinvestigation = إعادة تحقيق
Reinvesting = إعادة إستثمار
Reinvestment = إعادة الإستثمار
Reinvests = يعيد إستثمار
Reinvigorate = نشّط
Reinvigorated = منشّط
Reinvigorates = ينشّط
Reinvigorating = التنشيط
Reinvigoration = إعادة إنتعاش
Reinvite = جدّد دعوة
Reinvited = مجدّد دعوة
Reinvites = يجدّد دعوة
Reinviting = تجديد دعوة
Reinvoked = متضرّع ثانية
Reinvolve = تدخّل ثانية
Reinvolved = متدخّل ثانية
Reinvolvement = إعادة تدخّل
Reinvolves = يتدخّل ثانية
Reinvolving = تدخّل ثانية
Reissue = إعادة التوزيع
Reissued = معاد إصدار
Reissuer = إعادة مصدّر
Reissues = يعيد إصدار
Reissuing = إعادة إصدار
Reiterant = تكراري ثانية
Reiterate = كرّر
Reiterated = مكرّر
Reiterates = يكرّر
Reiterating = التكرار
Reiteration = التكرار
Reiterations = التكرار
Reiterative = تكراري
Reiteratively = بشكل تكراري
Reject = المرفوض
Rejectable = قابل للرفض
Rejected = مرفوض
Rejecter = الرّافض
Rejecting = الرفض
Rejectingly = بشكل رافض
Rejection = الرفض
Rejections = الرفض
Rejective = رفضي
Rejector = الرافض
Rejects = المرفوضون
Rejigger = عدّل
Rejoice = إبتهج
Rejoiced = مبتهج
Rejoicer = السّعيد
Rejoices = يبتهج
Rejoicing = الإبتهاج
Rejoicingly = بصورة سعيدة
Rejoin = إنضمّ ثانية إليه
Rejoinder = الردّ
Rejoined = منضمّ ثانية إلى
Rejoining = الإنضمام ثانية إلى
Rejoins = ينضمّ ثانية إليه
Rejudge = أعد تفحص
Rejuvenate = جدّد
Rejuvenated = مجدّد
Rejuvenates = يجدّد
Rejuvenating = التجديد
Rejuvenation = التجديد
Rekindle = ألهب
Rekindled = ألهب
Rekindler = إعادة شاعل
Rekindles = يلهب
Rekindling = الإلهاب
Reknit = إعادة تحوك
Relabel = أعد تعليم
Relabeled = إعادة إعتبرت
Relabeling = إعادة تعريف
Relabels = يعيد تعليم
Reland = إهبط ثانية
Relapse = المعاودة
Relapsed = راجع
Relapser = المنتكس
Relapses = المعاودة
Relapsing = الرجوع
Relate = تعلّق به
Related = ذو علاقة
Relatedly = بشكل ذو علاقة
Relatedness = العلاقة
Relater = تالي ثانية
Relates = يتعلّق به
Relating = التعلّق
Relation = العلاقة
Relational = علائقي
Relationally = بشكل علائقي
Relations = العلاقات
Relationship = العلاقة
Relationships = العلاقات
Relative = القريب
Relatively = نسبيا
Relativeness = النّسبيّة
Relatives = الأقرباء
Relativism = النسبوية
Relativist = المؤمن بالنّسبيّة
Relativistic = نسبي
Relativistically = بالنسبية
Relativities = النسبية
Relativity = النسبية
Relax = إرتح
Relaxant = المرخي
Relaxation = الإرخاء
Relaxations = الإرخاء
Relaxed = مرتاح
Relaxedly = بارتياح
Relaxedness = الإسترخاء
Relaxer = المهدّيء
Relaxes = يرتاح
Relaxing = الإرتياح
Relay = التقوية
Relayed = نقل
Relaying = النقل
Relays = التبديلات
Relearn = إعادة تتعلّم
Relearned = متعلّم ثانية
Relearning = إعادة تعلّم
Releasable = قابل للتأجير ثانية
Release = الإطلاق
Released = مصدر
Releaser = المحرّر - من الحريّة
Releases = الإطلاقات
Releasing = الإصدار
Relegate = إنف
Relegated = منفي
Relegates = ينفي
Relegating = النفي
Relegation = الإحالة
Relent = لن
Relented = ملين
Relenting = الليونة
Relentless = عنيد
Relentlessly = باستمرار
Relentlessness = القسوة
Relents = يلين
Relevance = الصلة
Relevances = الصلات
Relevancy = الصلة بالموضوع
Relevant = ذو العلاقة
Relevantly = بصلة وثيقة
Reliabilities = الثقة
Reliability = الثقة
Reliable = موثوق
Reliableness = الثقة، الإعتمادية
Reliably = بشكل موثوق
Reliance = الإعتماد
Reliant = متّكل
Reliantly = بإعتماد
Relic = الأثر
Relicense = إعادة رخصة
Relicensed = مجاز ثانية
Relicenser = إعادة مجيز
Relicensing = إعادة ترخيص
Relics = الآثار
Relict = ريليكت
Relicts = البقايا
Relied = معتمد
Relief = الإغاثة
Reliefs = الراحة
Relier = إعادة كذّاب
Relies = يعتمد
Relievable = ممكن التخلّص منه
Relieve = إشعر بالإرتياح
Relieved = مرتاح
Relievedly = بشكل مرتاح
Reliever = المخلّص، المريح من..
Relieves = الإستراحة
Relieving = شعور بالإرتياح
Religion = الدين
Religions = الأديان
Religiosity = التّقوى المبالغة
Religious = ديني
Religiously = دينيا
Religiousness = التّديّن
Relinking = إعادة إرتباط
Relinquish = إترك
Relinquished = متروك
Relinquishes = يترك
Relinquishing = الترك
Relinquishment = التخلي
Reliquary = وعاء الذخائر المقدسة
Relish = المذاق
Relishable = قابل للمتعة
Relished = إستمتع به
Relishes = المذاق
Relishing = الإستمتاع
Relive = عش ثانية
Relived = معيش ثانية
Relives = يعيش ثانية
Reliving = عيش ثانية
Reload = أعد تحميل
Reloaded = معاد تحميل
Reloader = إعادة محمّل
Reloading = إعادة تحميل
