Roarer = المزمجر، المتكلم بصوت عالي
Roaring = الهدر
Roaringest = صاخب
Roars = الزئير
Roast = الشواء
Roasted = محمّص
Roaster = مشوي
Roasting = التحميص
Roasts = يحمّص
Rob = روب
Robbed = مسروق
Robber = السارق
Robberies = السرقات
Robbers = اللصوص
Robbery = السرقة
Robbie = روبي
Robbin = روبن
Robbing = السرقة
Robbins = روبينس
Robe = الرداء
Robed = ملبس
Robert = روبرت
Roberta = روبيرتا
Roberto = روبيرتو
Roberts = روبرتس
Robertson = روبيرتسون
Robertsons = روبيرتسونس
Robes = الأردية
Robin = روبن
Robing = الإلباس
Robins = روبينز
Robinson = روبنسن
Robinsonville = روبنسونفيل
Robot = الإنسان الآلي
Robotic = آلي
Roboticist = متخصص في علم الرّوبوت
Robotics = علم الإنسان الآلي
Robotism = علم الإنسان الآلي
Robots = الرجال الآليون
Robs = يسرق
Robust = متين
Robustly = بشدّة
Robustness = القوّة
Rocco = روكو
Rochester = روتشستر
Rock = الصخرة
Rockaway = الحنطور
Rockaways = الحناطير
Rockbound = محاط بالصّخور
Rocked = مهزوز
Rockefeller = روكيفيلير
Rocker = الكرسي الهزاز
Rockeries = الجنائن
Rockers = الكراسي الهزازة
Rockery = الجنينة
Rocket = الصاروخ
Rocketed = مرتفع بحدّة
Rocketing = إرتفاع بحدّة
Rocketry = دراسة وتصميم الصواريخ
Rockets = الصواريخ
Rockfall = الصّخور المتساقطة
Rockford = روكفورد
Rockier = صخري
Rockies = روكيز
Rockiest = صخري
Rockily = بشكل قلق
Rockiness = الصّلابة
Rocking = الهزّ
Rocking chair = الكرسيّ الهزّاز
Rocking horse = الحصان الهزّاز
Rockland = روكلاند
Rocks = الصخور
Rockville = روكفيل
Rockwell = روكويل - رسّام أمريكيّ
Rockwood = روكوود
Rocky = صخري
Rococo = مزخرف
Rod = القضيب
Rodding = التنظيف باستخدام الأنابيب
Rode = طر
Rodent = قارض
Rodents = القوارض
Rodeo = مسابقة رعاة البقر
Rodeos = مسابقة رعاة البقر
Rodgers = روجيرس
Rodney = رودني
Rodriguez = رودريجو
Rods = القضبان
Roe = الظبي
Roebuck = ذكر الأيل
Roebucks = ذكور الأيل
Roentgen = رونتجن - فيزيائيّ ألمانيّ
Roentgenize = عرّض لأشعة إكس
Roes = الظبيان
Roger = روجر
Rogers = روجرز
Rogue = الغشّاش
Rogueries = النصب
Roguery = النصب
Rogues = الغشّاشون
Roguing = الإجتثاث
Roguish = خبيث
Roguishly = بشكل خبيث
Roguishness = الخبث
Roil = عكّر
Roiling = التعكير
Roister = عربد
Roistered = معربد
Roisterer = المعربد
Roistering = العربدة
Roisters = يعربد
Roland = رولند
Role = الدور
Roles = الأدوار
Roll = اللفّة
Rollable = قابل للدحرجة
Rollback = التّراجع
Rolled = ملفوف
Roller = الدحروجة
Roller-skate = المزلجة
Rollers = الدحروجات
Rollick = المرح
Rollicked = مارح
Rollicking = المرح
Rollickingly = بشكل مارح
Rollicks = المرح
Rollie = السيجارة الملفوفة باليد
Rolling = الطوي
Rollins = رولنز
Rollover = الإضافة
Rolls = اللفّات
ROM = الذاكرة التي تُقرأ ولا يُكتب إليها
Roman = الروماني
Romance = الرومانسية
Romanced = مغازل
Romancer = الرومانسي
Romancers = الرومانسيون
Romances = الرومانسيات
Romancing = المغازلة
Romanesque = رومانسي
Romania = رومانيا
Romanian = الروماني
Romano = رومانو
Romans = الرومان
Romantic = رومانسي
Romantically = عاطفيا
Romanticism = الخيالية
Romanticist = العاطفي
Romanticize = غازل
Romanticized = مغازل
Romanticizes = يغازل
Romanticizing = المغازلة
Romantics = الرّومانسيّون
Rome = روما
Romeo = روميو
Romeos = روميوس
Romp = اللعب
Romped = ملعوب
Romper = رومبير
Rompers = السروال القصير
Romping = اللعب
Romps = الألعاب
Romulus = رومولوس
Ron = رون
Ronald = رونالد
Rondo = المقطوعة الموسيقية
Rondos = المقطوعات الموسيقية
Ronnie = روني
Rood = الصليب
Roof = السقف
Roof garden = الحديقة العلويّة
Roofed = سقّف
Roofer = بنّاء الأسقف
Roofers = بنّاءون الأسقف
Roofing = السقف
Roofings = السقف
Roofs = السقوف
Rooftop = السقف
Rooftops = السقوف
Rooftree = الدّعامة
Rook = الغراب
Rooked = مغشوش
Rookeries = المغدفات
Rookery = المغدفة
Rookie = المجنّد الجديد
Rookies = المجندون الجدد
Rooks = الغربان
Rooky = روكي
Room = الغرفة
Roomed = سكن
Roomer = ذو الغرف ال
Roomers = المستأجرون
Roomful = الغرفة الكاملة
Roomier = واسع
Roomiest = واسع
Roominess = السّعة
Rooming = السكون
Roommate = شريك الغرفة
Roommates = شركاء الغرفة
Rooms = الغرف
Roomy = واسع
Rooney = روني
Roosevelt = روزفيلت
Rooseveltian = متعلق بـ فرانكين روزفيلت
Roost = المجثم
Roosted = جاثم
Rooster = الديك
Roosters = الديكة
Roosting = الجثم
Roosts = المجاثم
Root = الجذر
Rooted = مجذّر
Rootedness = العراقة
Rooter = المشجّع
Rooting = التجذير
Rootless = بدون جذور
Rootlessness = إنعدام الجذور
Roots = الجذور
Rootstock = الجذر
Rope = الحبل
Roped = مشدود
Ropemaker = صانع الحبال
Roper = صانع الحبال
Ropers = صانعو الحبال
Ropes = الحبال
Ropeway = النقل بالحبال
Roping = الشدّ
Ropy = سيّئ
Rorschach = إختبارات رورسكاتش
Rosa = روزا
Rosabelle = روزابيل
Rosalie = روزالي
Rosaries = المسبحات
Rosary = المسبحة
Rose = الوردة
Roseate = وردي
Roseately = بتفاؤل
Rosebud = البرعم
Rosebuds = البراعم
Rosebush = غصن الورد
Rosebushes = أغصان الورد
Rosehip = ثمرة الزّهرة
Roseland = روزلاند
Rosella = روزيلا
Rosemaries = أكاليل الجبل
Rosemary = روزماري
Rosen = يحتوي على الورد
Rosenberg = روزنبيرج
Rosenblum = روزنبلوم
Rosenthal = روزنثال
Rosenzweig = روزنزويج
Roses = الورد
Rosetta = روزيتا
Rosette = روزيت
Rosettes = روزتيس
Rosewood = روزوود
Rosie = روزي
Rosier = أكثر وردية
Rosiest = أكثر وردية
Rosin = الراتينج الصنوبري
Rosiness = التّورّد
Ross = روس
Rossi = روزسي
Roster = قائمة الأسماء
Rostrum = المنصة
Roswell = روزويل
Rosy = الوردي
Rot = التعفن
Rotarian = عضو في نادي الروتاري
Rotarians = أعضاء في نادي الروتاري
Rotary = دوّار
Rotatable = قابل للتدوير
Rotate = در
Rotated = مدار
Rotates = يدور
Rotating = الإدارة
Rotation = الدوران
Rotational = تدويري
Rotationally = بشكل تدويري
Rotations = الدورات
Rotative = دائر
Rotatively = بشكل دائر
Rotator = الدّوّار
Rotators = الدّوّارات
Rotatory = دائري
ROTC = هيئة تدريب ضباط الاحتياط
Rote = التكرار
Rotenone = روتينون - مبيد حشرات
Roth = روث
Rothschild = روثشيلد
Rotisserie = المشواة
Rotogravure = المطبوعات
Rotogravures = المطبوعات
Rotor = الدوّار
Rotors = الدوّار
Rototill = يحرث
Rots = التعفن
Rotted = متعفّن
Rotten = متعفّن
Rottenest = متعفّن
