Staler = أفسد
Stales = ياخي
Stalest = أفسد
Staley = ستالي
Stalin = ستالين
Staling = البوخ
Stalinist = ستاليني
Stalk = القصبة
Stalked = مطارد
Stalker = الملاحق
Stalkers = الملاحقون
Stalking = الملاحقة
Stalks = القصبات
Stall = الكشك
Stallage = روث الأبقار مخلوطا بالقش
Stalled = متوقّف
Stalling = التوقّف
Stallings = ستولينجز
Stallion = الحصان
Stallions = الحصن
Stalls = الأكشاك
Stalwart = النصير
Stalwartly = بشكل مخلص
Stalwartness = القوّة
Stamen = السداة
Stamens = السداة
Stamford = ستامفورد
Stamina = الطاقة
Staminate = ذو سداة
Stammer = التمتمة
Stammered = متلعثم
Stammerer = المتهته في الكلام
Stammering = التلعثم
Stammers = التمتمة
Stamp = الطابع
Stamp-pad = وسادة طابع
Stamped = مختوم
Stampede = الإندفاع
Stampeded = إندفع فرارا
Stampeder = أحد الفارّين في الفرار الجماعيّ
Stampedes = يندفع فرارا
Stampeding = الفرار الجماعي
Stamper = الختّام
Stampers = الختّامون
Stamping = الختم
Stamps = الطوابع
Stan = ستان
Stance = الموقف
Stances = المواقف
Stanch = أوقف
Stanched = موقف
Stancher = الحازم
Stanches = يوقف
Stanchest = الحازم
Stanching = الإيقاف
Stanchion = الدعامة
Stanchioned = دعّم
Stanchioning = التدعيم
Stanchions = الدعامات
Stand = الجناح
Standalone = مستقلّ
Standard = المعيار
Standardization = توحيد المقياس
Standardizations = توحيد المقياس
Standardize = وحّد
Standardized = قياسي
Standardizer = موحّد المقاييس
Standardizes = يوحّد
Standardizing = التوحيد
Standardly = بشكل قياسي
Standards = المعايير
Standby = البديل
Standee = الواقف
Stander = الواقف
Standing = الموقف
Standings = المقامات
Standish = تقريبا جناح
Standoff = المواجهة
Standoffish = منعزل
Standoffishly = بشكل منعزل
Standpipe = الماسورة العموديّة
Standpipes = المواسير العموديّة
Standpoint = وجهة النظر
Standpoints = وجهات النظر
Stands = الأجنحة
Standstill = التوقّف تامّ
Standstills = التوقّف
Stanford = ستانفورد
Stanhope = الحنطور
Stank = نتن
Stanley = ستانلي
Stannic = يحتوي او متعلق بالصفيح
Stannous = يحتوي او متعلق بالصفيح
Stans = ستانز
Stanton = ستانتن
Stanza = المقطع الشعري
Stanzas = المقاطع الشعرية
Staph = ستاف - نوع من البكتيريا
Staphylococcus = بكتيريا
Staple = المشبك
Stapled = مدبّس
Stapler = الكبّاسة
Staplers = الكبّاسات
Staples = المشابك
Stapleton = ستابلتون
Stapling = التدبيس
Star = النجم
Star-shaped = نجمي
Starboard = الميمنة
Starboards = ميمنات المراكب
Starch = النشا
Starched = منشّى
Starches = النشا
Starchier = نشوي
Starchiest = نشوي
Starchiness = النّشويّة
Starching = التنشية
Starchy = نشوي
Stardom = النجومية
Stare = التحديق
Stared = محدّق
Starer = لامع
Stares = التحديق
Starfish = نجم البحر
Starfishes = نجوم البحر
Stargaze = ستارجاز
Stargazer = مراقب النجوم
Stargazers = مراقبوا النجوم
Stargazes = يتأمّل النّجوم
Stargazing = تأمّل النجوم
Staring = التحديق
Stark = بالكامل
Starkest = أشدّ
Starkey = ستاركي
Starkly = على نحو كبير
Starkness = الشدّة، القوة، التمام
Starless = بدون نجوم
Starlet = النجيم
Starlets = النجيّمات
Starlight = ضوء النجوم
Starlights = أضواء النجوم
Starlike = نجمي
Starling = الزرزور
Starlings = الزرازير
Starlit = مضاء بالنجوم
StarOffice = ستارأوفايس
Starr = ستار
Starred = تألّق
Starrier = مليء بالنجوم
Starriest = مليء بالنجوم
Starring = بطولة
Starry = مليء بالنجوم
Stars = النجوم
Starship = المركبة الفضائية
Start = البداية
Start-stop = توقّف بداية
Start-up = البدء
StartCode = ابدأ
Started = مبدوء
Starter = المبدئ
Starters = المبدئ
Starting = البدء
Startle = باغت
Startled = مذهل
Startles = يباغت
Startling = المباغتة
Startlingly = بشكل مذهل
Startlingness = الذّهول
Starts = البدايات
StartStack = ابدأ
StartTime = ابدأ
Startup = البدء في التشغيل، ابتدائيّ
Startups = البدء
Starvation = المجاعة
Starve = جوّع
Starved = مجوّع
Starveling = المتضور
Starvelings = المتضورون
Starves = يجوّع
Starving = التجويع
Stash = أخف
Stashed = مخفى
Stashes = يخفي
Stashing = الإخفاء
Stasis = التّوازن
Stat = مباشرة
State = الحالة، الدولة، يقرّ
Statecraft = أصول الحكم
Stated = منصوص
Statedly = بشكل منصوص
Statehood = الدولة
Statehouse = مبنى المجلس التشريعي
Stateless = بلا وطن
Statelessness = عدم الانتماء لدولة معيّنة
Statelier = مهيب
Stateliness = العظمة
Stately = مهيب
Statement = البيان
Statements = البيانات
Staten = ستاتين
StateProvince = الوﻻيةالمحافظة
Stater = رسمي
Stateroom = قاعة المناسبات
States = الولايات
Statesman = رجل الدولة
Statesmanlike = كرجل دولة
Statesmanly = قيادي
Statesmanship = الفطنة السياسية
Statesmen = رجال الدولة
Stateswoman = إمرأة دولة
Stateswomen = نساء دولة
Statewide = في عموم الولاية
Static = الخشخشة
Statically = سكونياً، خمولياً
Statics = علم توازن القوى
Stating = الذكر
Station = المحطة
Stationaries = القرطاسية
Stationary = ثابت
Stationed = منسّب
Stationer = بائع القرطاسيّة
Stationeries = القرطاسية
Stationers = باعة القرطاسية
Stationery = القرطاسية
Stationing = التركيز
Stationmaster = مدير المحطة
Stations = المحطات
Statistic = الإحصائية
Statistical = إحصائي
Statistically = بشكل إحصائي
Statistician = الخبير الإحصائي
Statisticians = الخبراء الإحصائيون
Statistics = الإحصائيات
Stative = خبريّ
Statler = ستاتلر - مقاول سلسلة فنادق. أمريكيّ
Stator = الجزء السّاكن في الموتور او المولد الكهربائي
Stats = الإحصائيات
Statuaries = التماثيل
Statuary = فن النحت
Statue = التمثال
Statued = تصلّب في مكانة، بلا حراك
Statues = التماثيل
Statuesque = تمثالي
Statuesquely = بشكل تمثالي
Statuette = التمثال الصغير
Stature = القوام
Statures = القامات
Status = المنزلة
Statusbar = شريط الحالة
Statuses = المنزلة
Statute = القانون
Statutes = القوانين
Statutorily = شرعيًّا، قانونياً
Statutory = قانوني
Stauffer = ستوفر
Staunch = وفي
Staunchest = أكثر وفاء
Staunchly = بثبات
Staunchness = القوّة
Staunton = ستانتون
Stave = العصا
Staved = مثقوب
Staves = العصي
Staving = الثقب
Stay = الإقامة
Stay-down = إبق أسفل
Stayed = باق
Stayer = قويّ التّحمّل
Stayers = أقوياء التّحمّل
Staying = البقاء
Stays = الإقامات
Stdio = الدّاخل و النّاتج العاديّان - برمجيات
Stead = المكان
Steadfast = صامد
Steadfastly = بصمود
Steadfastness = الصمود
Steadied = تثبّت
Steadier = أكثر ثباتا
Steadies = يتثبّت
Steadiest = أكثر ثباتا
Steadily = بثبات
Steadiness = الثبات
Steadinesses = الثبات
Steading = المزرعة، يخدم
Steads = الأماكن
Steady = ثابت
Steadying = التثبيت
Steak = شريحة لحم البقر
Steaks = شريحة لحم البقر
Steal = إسرق
Stealer = ستيلير
Stealing = السرقة
Steals = يسرق
Stealth = الخلسة
Stealthier = أكثر خفيةً
Stealthily = خلسة
Stealthiness = الخِفية
Stealthy = شبحي
Steam = البخار
Steamboat = المركب البخاري
