Stinging = اللسع
Stingingly = على نحو لاسع
Stings = اللدغ
Stingy = بخيل
Stink = النتانة
Stinker = الكريه
Stinkers = الكريهون
Stinkier = أسوء
Stinkiest = أسوء
Stinking = النتن
Stinkingly = بشكل سيئ
Stinkingness = النّتانة
Stinkpot = نوع من السلاحف، الشخص الممقوت
Stinks = ينتن
Stinky = نتن
Stint = المهمّة
Stinted = مقتّر
Stinter = ستينتر
Stinting = التقتير
Stints = المهمّات
Stipend = الراتب
Stipends = الرواتب
Stipple = الرسم النقطي
Stippled = منقّر
Stippler = الرسام الذي يستعمل طريقة التنقيط في الرسم
Stipples = الرسوم النقطية
Stippling = التنقير
Stipulate = إشترط
Stipulated = مشترط
Stipulates = يشترط
Stipulating = الإشتراط
Stipulation = الإشتراط
Stipulations = الإشتراطات
Stipulatory = شَرطي
Stir = التحريك
Stirling = ستيرلينج
Stirred = محرّك
Stirrer = النّمّام
Stirrers = النّمّامون
Stirring = الإثارة
Stirringly = بشكل مثير
Stirrings = الحركة
Stirrup = الركاب
Stirrups = الركاب
Stirs = الحركات
Stitch = الإبرة
Stitched = مخيّط
Stitcher = الخيّاطة
Stitches = الإبر
Stitching = التخييط
Stoat = القاقم
Stochastic = عشوائيّ
Stochastically = عشوائيًّا
Stock = السهم
Stock-account = حساب سهم
Stock-check = مراقبة سهم
Stock-keeping = إستمرار بالسهم
Stock-receipt = إيصال سهم
Stockade = الحاجز
Stockaded = مطوّق
Stockades = الحواجز
Stockading = التطويق
Stockbroker = سمسار البورصة
Stockbrokers = سماسرة البورصة
Stocked = مجهّز
Stocker = ستوكير
Stockers = ستوكيرس
Stockfish = ستوكفيش
Stockholder = صاحب الأسهم
Stockholders = أصحاب الأسهم
Stockholm = إستوكهولم
Stockier = أضخم جثّة
Stockiest = أسمن
Stockily = بشكل مربع القامة
Stockiness = القوّة
Stocking = الجورب
Stockinged = مرتدية جوارب
Stockings = الجوارب النسائية
Stockpile = المخزون الاحتياطي
Stockpiled = مخزون
Stockpiler = المكدّس
Stockpiles = المخزون الاحتياطي
Stockpiling = التخزين
Stockroom = المخزن
Stockrooms = المخازن
Stocks = الأسهم
Stocktaking = الجرد
Stockton = ستوكتون
Stocky = ممتلئ الجسم
Stockyard = الحظيرة
Stockyards = الحظائر
Stodged = مطعم
Stodgier = أثقل
Stodgiest = أثقل
Stodgily = بشكل ثقيل
Stodginess = الثّقل
Stodgy = ثقيل
Stoic = المتحمل
Stoical = صبور
Stoically = بصبر
Stoichiometric = متعلق بحساب العناصر المتفاعلة
Stoichiometry = حساب العناصر المتفاعلة
Stoicism = الرواقية
Stoicly = بشكل رواقّي
Stoics = المتحملون
Stoke = أذك
Stoked = مذكى
Stoker = الوقّاد
Stokers = الوقّادون
Stokes = يذكي
Stoking = الإذكاء
Stole = الشال
Stoled = لبس عباءة
Stolen = مسروق
Stoles = الشالات
Stolid = بليد
Stolidity = البلاهة
Stolidly = بشكل بليد
Stolidness = البلاهة
Stomach = المعدة
Stomachache = وجع المعدة
Stomached = متحمّل
Stomacher = ملبس حول الصدر والبطن
Stomachers = ملابس حول الصدر والبطن
Stomaches = الأمعاء
Stomaching = التحمّل
Stomachs = المعدة
Stomp = دس
Stomped = مداس
Stomping = الدوس
Stomps = يدوس
Stone = الحجارة
Stonecrop = السّيدوم - نبات
Stonecutter = الحجّار
Stonecutters = الحجّارون
Stoned = محشّش
Stonehenge = مكان صخري قديم في بريطانيا
Stonemason = الأواني الفخارية
Stonemasons = الحجّارون
Stoner = حجري
Stones = الأحجار
Stonewall = إرفض التعاون
Stonewalled = رفض التعاون
Stonewalls = يرفض التعاون
Stoneware = الأواني الفخارية
Stonewort = الطّحلب
Stonier = أكثر حجارة
Stoniest = أكثر حجارة
Stonily = بشكل حجري
Stoniness = الجمود
Stoning = الرجم
Stonings = الرجم
Stony = حجري
Stood = وقف
Stooge = العميل
Stooges = العملاء
Stooging = التّهريج
Stool = المقعد
Stools = المقاعد
Stoop = الإنحناء
Stooped = منحنى
Stooping = الإنحناء
Stoops = الإنحناءات
Stop = التوقّف
Stopband = الترددات التي لايسمح لها بالمرور
Stopcock = الصمّام
Stopcocks = الصمّامات
Stopgap = مؤقّت
Stopgaps = البدائل
Stoplight = إشارة المرور
Stoplights = إشارات المرور
Stopover = التوقّف
Stopovers = التوقّف
Stoppable = يمكن أيقافه
Stoppage = التوقّف
Stoppages = التوقّف
Stopped = توقّف
Stopper = السدادة
Stoppered = سدّ، أغلق
Stoppering = السّد، الإغلاق
Stoppers = السدادات
Stopping = الإيقاف
Stoppled = مسدود
Stopples = يسدّ
Stoppling = السدّ
Stops = التوقّفات
Stopwatch = الساعة التوقيتية
Stopwatches = الساعات التوقيتية
Storage = الخزن
Storages = المخازن
Store = المخزن
Store-and-forward = المخزن والمهاجم
Stored = مخزون
Stored-program = البرنامج المخزون
Storefront = واجهة المخزن
Storefronts = واجهات المخازن
Storehouse = المخزن
Storehouses = المخازن
Storekeeper = أمين المخزن
Storekeepers = أمناء المخازن
Storeroom = المخزن
Storerooms = المخازن
Stores = المخازن
Storey = الطابق
Storeys = الطوابق
Storied = طابق، دور
Stories = القصص
Storing = الخزن
Stork = اللقلق
Storks = اللقالق
Storm = العاصفة
Stormbound = معزول بسبب العواصف
Stormed = مقتحم
Stormier = أشدّ عصفا
Stormiest = أشدّ عصفا
Storminess = العصف
Storming = الإقتحام
Storms = العواصف
Stormy = عاصف
Story = القصّة
Storyboard = القصّة المصورة
Storyboards = القصص المصورة
Storybook = قصّة الأطفال
Storybooks = قصص الأطفال
Storying = القاء القصّة
Storyteller = راوي القصص
Storytellers = رواة القصص
Stouffer = ستوفر
Stout = بيرة ستاوت
Stouten = يشجّع
Stoutened = تشجّع
Stoutening = التشجيع
Stouter = شجاع
Stoutest = شجاع
Stoutly = بقوة
Stoutness = الشّجاعة
Stove = الطبّاخ
Stovepipe = المدخنة، القبّعة
Stovepipes = المداخن، القبّعات
Stover = العلف
Stoves = الطبّاخات
Stow = عبّئ
Stowage = التخزين، المخزن
Stowaway = المسافر المتهرب
Stowaways = المسافرون المتهربون
Stowe = ستو - كاتب أمريكيّ
Stowed = محفوظ
Stowing = التعبئة
Stows = يعبّئ
Strabismic = مصاب بحول
Strabismus = الحول
Straddle = فحّج
Straddled = مفحّج
Straddler = المتواجد في مكانين. كما السيارة التي تسير على الخط المتقطّع في الشارع
Straddles = يفحّج
Straddling = التفحيج
Strafe = إقصف
Strafed = مقصوف
Strafer = المهاجم
Strafes = يهاجم
Strafing = القصف
Straggle = ته
Straggled = متيه
Straggler = المتطرّف
Stragglers = المتطرّفون
Straggles = يتيه
Straggling = التيه
Straggly = مبعثر
Strahl = ستراهل
Straight = مباشرة
Straight-line = الخطّ المستقيم
Straightaway = فورا
Straighten = عدّل
Straightened = معدّل
Straightener = جاعل الشيء مستقيم. كمنعّم الشّعر الأجعد
Straightening = التعديل
Straightens = يعدّل
Straighter = أكثر استقامة
Straightest = الأكثر استقامة
Straightforward = بسيط
Straightforwardly = ببساطة
Straightforwardness = الاستقامة، الصّراحة
Straightforwards = المستقيمون، الصّرحاء
Straightly = بصراحة
Straightness = الاستقامة
Straights = المستقيمون
Straightway = حالا
Strain = الإجهاد
Strained = متوتّر
Strainer = المصفاة
Strainers = المصافي
Straining = الإجهاد
Strains = الإجهاد
Strait = المضيق
Straiten = إحصر
Straitened = ضيّق
Straitening = الحصر
Straitens = يحصر
Straitjacket = القيود
Straitjackets = القيود
