Believably = على نحو يصدّق
Believe = صدّق
Believed = صدّق
Believer = المؤمن
Believers = المؤمنون
Believes = يصدّق
Believing = التّصديق
Belittle = استهن
Belittled = استهان
Belittlement = الاستخفاف
Belittler = مستهين
Belittles = يستهين
Belittling = الاستهانة
Belize = بيليز
Bell = الجرس
Bella = بيلا
Belladonna = البيلادونا
Bellamy = بيلامي
Bellatrix = بيلاتريكس
Bellboy = الفرّاش
Bellboys = الفرّاشون
Belle = الحسناء
Belles = الحسناوات
Belleville = بيليفيل
Bellflower = زهرة الجرس
Bellhop = الفرّاش
Bellhops = الفرّاشون
Bellicose = عدوانيّ
Bellicosely = بشكل عدواني
Bellicoseness = عدوانيّة
Bellicosities = العدوانيّ
Bellicosity = العدوانيّة
Bellied = ذو بطن
Bellies = البطون
Belligerence = العدوانيّة
Belligerencies = العدوانيّ
Belligerency = العدوانيّة
Belligerent = عدوانيّ
Belligerently = على نحو قتاليّ
Belligerents = المحاربون
Bellingham = بيلينجهام
Bellini = بيليني
Bellman = المنادي
Bellmen = المنادون
Bellow = الخوار
Bellowed = خار
Bellowing = الخوار
Bellows = الخوار
Bells = الأجراس
Bellum = جميل
Bellwether = الكرّاز
Bellwethers = الكرّاز
Bellwood = بيلوود
Belly = البطن
Bellyache = المغص
Bellyacher = ممغوص
Bellyaching = التوجّع
Bellybutton = السّرّة
Bellybuttons = السّرر
Bellyful = المقدار الكبير
Bellyfull = كعكة كبيرة محلّاة
Bellying = النفخ
Belmont = بلمنت
Beloit = بِلُيْتْ
Belong = خصّ
Belonged = خصّ
Belonging = الخصوص
Belongingness = الطمأنينة
Belongings = المتعلّقات
Belongs = يخصّ
Belove = أحب
Beloved = محبوب
Below = إلى أسفل
Belshazzar = بلشزار
Belt = الحزام
Belted = مربوط
Belting = مادّة لصنع السّيور
Belton = بيلتون
Belts = الأحزمة
Beltsville = بيلتسفيل
Belushi = بيلشي
Belvedere = بلفيدير
Belvidere = بيلفيدير
Bely = بيلي
Belying = الكذب
BEMA = المقدس
Beman = بيمان
Bemoan = تحسّر
Bemoaned = تحسّر
Bemoaning = التّحسّر
Bemoans = يتحسّر
Bemuse = أذهل
Bemused = مندهش
Bemusedly = في حيرة
Ben = المرتفع
Bench = المقعد
Benched = طرد
Bencher = عضو هيئة المحكمة
Benches = المقاعد
Benching = الطّرد
Benchmark = المعيار
Benchmark-Tests = اختبارات المعيار
Benchmarking = قياس المعايير
Benchmarks = علامات خاصّة بأعمال المساحة
Bend = انحن
Bendable = قابل للانحناء
Bended = محنيّ
Bender = الشّاذّ
Benders = الشّواذّ
Bending = الانحناء
Bendix = بنديكس
Bends = المنحنيات
Beneath = أسفل
Benedict = حديث الزّواج
Benedictine = البينديكتين
Benedictines = البينديكتين
Benediction = الدّعاء
Benedictions = الأدعية
Benedictive = دُعائيّ
Benedictory = مبارك
Benedikt = بنيديكت
Benefaction = الإحسان
Benefactions = التّبرّعات
Benefactor = المتبرّع
Benefactors = المتبرّعون
Benefice = المنصب
Beneficence = الإحسان
Beneficences = الإحسان
Beneficent = متصدّق
Beneficently = بإحسان
Benefices = المناصب
Beneficial = مفيد
Beneficially = بشكل مجدي
Beneficialness = الاستفادة
Beneficiaries = المستفيدون
Beneficiary = المستفيد
Benefit = الفائدة
Benefited = مستفاد
Benefiter = مُفيد
Benefiters = مفيدون
Benefiting = الإفادة
Benefits = الفائدات
Benelux = بينيلَكس
Benevolence = الكرم
Benevolent = خيريّ
Benevolently = بإحسان
Benevolentness = العطاء
Bengal = بينجال
Bengali = البنغاليّ
Benight = يضلل
Benighted = مضلَّل
Benightedly = بتضليل
Benightedness = حلول اللّيل
Benign = لطيف
Benignantly = بشكل حليم
Benignly = برقّة
Benin = بنين
Benjamin = بنيامين
Bennett = بينيت
Bennington = بينينجتون
Benny = بيني
Benson = بينسون
Bent = انحنى
Bentham = بينثام
Benthic = قعر مائيّ
Bentley = بينتلي
Benton = بينتون
Bents = الميول
Benumb = خدّر
Benz = بينز
Benzedrine = البنزيدرين
Benzene = البنزين
Benzin = بنزين
Benzine = البنزين
Beograd = بيوجراد
Beowulf = بياولف
Beplaster = يغطّي بضماد
Bequeath = ورّث
Bequeathed = ورّث
Bequeathing = التّوريث
Bequeathment = توريث
Bequeaths = يورّث
Bequest = التّركة
Bequests = التّركات
Berate = وبّخ
Berated = وبّخ
Berates = يوبّخ
Berating = التّوبيخ
Berea = ذو وزن
Bereave = احرم
Bereaved = مفجوع
Bereavement = الحرمان
Bereavements = الحرمان
Bereaves = يحرم
Bereaving = الحرمان
Bereft = بائس
Berenices = بيرينيسيس
Beresford = بيريسفورد
Beret = البيريه
Berets = البيريهات
Berg = الجبل الجليديّ
Bergamot = الشجرة برغموت
Bergen = برجِن
Berger = بيرجر
Bergland = برجﻻند
Berglund = برجﻻند
Bergman = بيرجمان
Bergs = الجبال الجليديّة
Bergson = بيرجيسون
Bergsten = بيرجستين
Bergstrom = بيرجستروم
Beribboned = مزيّن
Beriberi = البري بري
Beringer = برنجر
Berkeley = بيركيلي
Berkelium = البركيليوم
Berkowitz = بيركاويتز
Berkshire = بيركشاير
Berkshires = بيركشايرز
Berlin = برلين
Berliner = برليني
Berliners = برلينيّون
Berlioz = بيرليوز
Berlitz = بيرليتز
Berman = بيرمان
Bermuda = برمودا
Bern = برن
Bernadine = بيرناداين
Bernard = برنار
Bernardine = بيرنارداين
Bernardino = بيرناردينو
Bernardo = برناردو
Berne = برن
Bernet = بيرنيت
Bernhard = بيرنهأرد
Bernice = بيرنيس
Bernie = بيرني
Berniece = بيرنيس
Bernini = بيرنيني
Bernoulli = بيرنولي
Bernstein = بيرنشتاين
Berra = بيرا
Berried = منتج ثمر علّيق
Berries = التّوت
Berry = التّوت
Berrying = جمع التوت
Berserk = هائج
Berserker = هائج
Bert = بيرت
Berth = المرسى
Bertha = البرثيّة
Berthed = رسا
Berthing = الرّسو
Berths = المراسي
Bertie = بيرتي
Bertram = بيرترام
Bertrand = برتراند
Berwick = بيرويك
Beryl = البريل
Beryllium = البيريليوم
Bes = بيز
Beseech = التمس
Beseeched = التمس
Beseeches = يلتمس
Beseeching = التماس
Beseechingly = بتوسّل
Beseem = ناسب
Beseems = يناسب
Beset = حاصر
Besets = يحاصر
Besetting = الحصار
Beside = بجانب
Besides = بالإضافة إلى ذلك
Besiege = حاصر
Besieged = حاصر
Besiegement = حِصار
Besieger = المحاصر
Besiegers = المحاصرون
Besieges = يحاصر
Besieging = الحصار
Besmear = لطّخ
Besmeared = لطّخ
Besmearing = التّلطيخ
Besmears = يلطّخ
Besmirch = لطّخ
Besmirched = لطّخ
Besmirches = يلطّخ
Besmirching = التّلطيخ
Besom = المكنسة
Besoms = المكانس
Besot = أسكر
Besots = يسكر
Besotted = سكران
Besotting = الإسكار
Besought = التمس
Bespatter = لوّث
Bespattered = لوّث
Bespatters = يلوّث
Bespeak = دلّ
Bespeaking = الدّلالة
