Unconcern = عدم الإكتراث
Unconcerned = غير مكترث
Unconcernedly = بشكل غير مكترث
Unconcernedness = اللّامباﻻة
Unconcerns = عدم الإكتراث
Unconditional = غير مشروط
Unconditionally = بدون شرط
Unconditioned = غير مشروط
Unconfessed = غير مقرّ
Unconfidence = إنعدام الثقة
Unconfident = غير واثق
Unconfined = غير محصور
Unconfirmed = غير مؤكّد
Unconfirmedly = بشكل غير مؤكّد
Unconformable = غير مطيع
Unconformity = غير إلتزام
Uncongenial = غير مناسب
Uncongeniality = غير ملائمة
Unconnected = غير مرتبط
Unconnectedly = بشكل غير مرتبط
Unconning = الجهل بالأمر :: الجاهل بالأمور
Unconquerable = لايقهر
Unconquerably = بشكل لايقهر
Unconquered = لم يقهر
Unconscientious = غير متفاني
Unconscionable = غير مقبول
Unconscionableness = انعدام الضّمير
Unconscionably = بدون معقولية
Unconscious = العقل الباطن
Unconsciously = بشكل فاقد الوعي
Unconsciousness = عدم الشعور
Unconsecrated = غير معلن
Unconsenting = معارض
Unconsidered = غير مدروس
Unconsolidated = غير مدعوم
Unconspicuous = بسيط
Unconstant = غير ثابت
Unconstipated = لا يشكو من الإمساك
Unconstitutional = غير دستوري
Unconstitutionality = غير دستورية
Unconstitutionally = بشكل غير دستوري
Unconstrained = منطلق
Unconsumed = غير مستهلك
Unconsummated = ناقص
Uncontable = أنكونتابل
Uncontaminated = غير ملوّث
Uncontestable = مؤكّد
Uncontested = لا إعتراض عليه
Uncontinuous = غير مستمر
Uncontradicted = غير متناقض
Uncontrollability = غير قابلية تحكم
Uncontrollable = خارج السّيطرة
Uncontrollably = بدون سيطرة
Uncontrolled = غير مراقب
Uncontrolledly = بشكل غير مراقب
Uncontroversial = غير مثير للجدل
Uncontrovertible = مؤكّد
Unconvenient = غير مناسب
Unconventional = غير تقليدي
Unconventionality = الغير تقليديّة
Unconventionally = بشكل لا تقليدي
Unconverted = غير محوّل
Unconvertible = غير قابل للتحويل
Unconvinced = غير مقتنع
Unconvincedly = بشكل غير مقتنع
Unconvincing = غير مقنع
Unconvincingly = بشكل غير مقنع
Unconvincingness = اللّاإقناع
Uncooked = غير مطبوخ
Uncool = غير بارد
Uncooled = غير مبرّد
Uncooperative = غير تعاوني
Uncooperatively = بدون تعاون
Uncoordinated = غير منسّق
Uncord = يفك وثاق
Uncordial = غير ودّي
Uncordially = غير وديا
Uncork = إفتح
Uncorked = مفتوح
Uncorking = الفتح
Uncorks = يفتح
Uncorrectable = غير قابل للتصحيح
Uncorrected = غير مصحّح
Uncorrelated = غير مربوط
Uncorroborated = غير معضّد
Uncorrupt = غير فاسد
Uncorrupted = غير فاسد
Uncounselled = غير منصوح
Uncountable = غير معدود
Uncountably = بشكل غير محدود
Uncounted = غير معدود
Uncouple = إفصل
Uncoupled = مفصول
Uncouples = يفصل
Uncoupling = الفصل
Uncourageous = غير شجاع
Uncourteous = غير مهذّب
Uncous = كما الخطّاف
Uncousinly = بشكل غير ﻻئق بالقرابة
Uncouth = فظّ
Uncouthly = بشكل فظّ
Uncouthness = الفظاظة
Uncovenanted = غير ملزم
Uncover = إكشف
Uncovered = غير مغطّى
Uncovering = الكشف
Uncovers = يكشف
Uncrate = يزيل من الصّندوق
Uncreased = غير متجعّد
Uncreate = اهلك :: يهلك
Uncreated = غير مخلوق
Uncritical = غير ناقد
Uncritically = بشكل غير ناقد
Uncriticized = غير منتقد
Uncriticizing = غير إنتقاد
Uncropped = غير مقصوص
Uncross = غير متقاطع
Uncrossed = عديم التقاطع
Uncrosses = يلغي التقاطع
Uncrossing = غير عبور
Uncrowded = غير مزدحم
Uncrown = اخلع :: يخلع
Uncrowned = غير متوّج
Uncrushable = غير قابل للسحق
Uncrystallized = غير مبلور
Unction = مرهم
Unctious = دهنيّ
Unctuous = متزلف
Unctuously = بشكل متزلف
Unctuousness = التّملّق
Uncultivated = غير مهذّب
Unculture = فقدان الثّقافة :: انعدام الثّقافة
Uncultured = جاهل
Uncunning = جاهل :: الجهل
Uncurable = غير قابل للعلاج
Uncurbed = غير مكبوح
Uncured = غير معالج
Uncurl = سدّل
Uncurled = مسدّل
Uncut = غير مقطوع
Uncuth = غير معروف :: غريب
Uncynical = غير متهكم
Uncynically = بشكل غير متهكم
Uncypher = يفهم :: يفكّ الشفرة
Undam = يحرّر من القيود
Undamaged = سليم
Undamagedly = بشكل سليم
Undamped = غير ثبّط
Undatable = غير محدد او معرّف بتاريخ معيّن
Undated = غير مؤرّخ
Undaunted = غير متهيّب
Undauntedly = بإقدام
Undazzled = غير مبهر
Undeaf = يعالج الصّمم
Undebatable = غير قابل للنقاش
Undebugged = غير منقّح
Undecayed = غير فاسد
Undeceive = وضّح
Undeceived = موضّح
Undeceives = يوضّح
Undeceiving = التوضيح
Undecent = غير محترم
Undecidable = غير مقرّر
Undecide = يتراجع عن القرار
Undecided = متردّد
Undecidedly = بشكل متردّد
Undecipherable = مستحيل الحل
Undeciphered = غير محلول
Undecisive = غير حاسم
Undeck = غير طابق
Undeclared = غير مصرّح به
Undecomposable = غير متفسّخ
Undecorated = غير مزيّن
Undedicated = غير مكرّس
Undefatigable = نشيط
Undefeated = غير مهزوم
Undefendable = غير محمي :: معرّض للخطر
Undefended = غير محمي
Undefiled = غير مدنّس
Undefinable = غير قابل للتعريف
Undefine = يربك التّعريف
Undefined = غير معرّف
Undeflected = غير منحرف
Undeformed = غير مشوّه
Undelayed = غير متأخر
Undelete = أعد
Undeleted = أعيد
Undeliverable = غير قابل للتسليم
Undemanding = قنوع :: قليل الطّلبات
Undemocratic = غير ديموقراطي
Undemocratically = بشكل غير ديموقراطي
Undemonstrable = غير قابل للاثبات
Undemonstrative = متحفّظ
Undemonstratively = بشكل متحفّظ
Undemonstrativeness = التحفّظ
Undeniable = مستحيل النكران
Undeniableness = عدم النّكران
Undeniably = بشكل لاينكر
Undenominational = غير طائفي
Undependability = أنعدام الثّقة
Undependable = غير موثوق
Undepicted = غير مصوّر
Under = تحت
Under-coat = معطف داخلي :: طبقة دّهان مانعة للصّدأ
Under-study = الممثّل البديل
Under-way = جاري :: في طور التنفيذ
Underachiever = المقصّر في الأداء
Underachievers = المقصّرون
Underact = قصّر
Underacted = مقصّر
Underacting = التقصير
Underacts = يقصّر
Underage = القاصر
Underarm = الإبط
Underbear = يساند :: يتحمّل
Underbellies = أسفل البطن
Underbelly = أسفل البطن
Underbid = إخصم
Underbidding = الخصم
Underbids = يخصم
Underbodice = ملابس داخليّة قصيرة بلا كمّ للنّساء
Underbred = فظّ
Underbrush = الشّجيرات النّامية تحت الأشجار الكبيرة
Undercarriage = عجلات الطائرة
Undercarriages = عجلات الطائرة
Undercharge = إخصم
Undercharged = مخصوم
Undercharges = يخصم
Undercharging = الخصم
Underclass = الطّبقة الدّنيا من المجتمع
Underclassman = اللّامتخرّج
Underclassmen = طالب في المرحلة الأولى او الثانية في الجامعة
Underclothes = الملابس الداخليّة
Underclothing = الملابس الداخليّة
Undercoat = الطلاء التحتي
Undercoats = الستر التحتانية
Underconsumption = قلّة الاستهلاك
Undercooked = غير مطبوخ جيدا
Undercount = سجّل عدداً أقل
Undercounts = يسجّل عدداً أقل
Undercover = سريّ
Undercurrent = التيّار التحتي
Undercurrents = التيّارات التحتية
Undercut = لحم المتن
Undercuts = لحوم المتن
Undercutting = البيع بسعر أدنى
Underdeveloped = متخلّف
Underdevelopment = نقْص النّموّ
Underdo = تهاون في العمل
Underdog = المستضعف
Underdogs = المستضعفون
Underdone = غير تام
Underdose = جرعة الدواء الغير كافية
Underdrain = ممر لصرف المياه
Undereducated = رديء التعلّم
Underemphasize = يقلّل التأكيد
Underemphasized = قليل التأكيد
Underemphasizes = يقلّل التّأكيد
Underemphasizing = تقليل التّأكيد
Underemployed = أسيء استغلال مهاراته
Underemployment = إساءة استغلال المهارات
Underestimate = قلّل من تقدير
Underestimated = قلّل من تقدير
Underestimates = يقلّل من تقدير
Underestimating = تقليل من تقدير
Underestimation = قلّة التقدير
Underexpose = عرّض قليلا
Underexposed = معرّض قليلا
Underexposes = يعرّض قليلا
Underexposing = تعريض قليلا
Underexposure = التّعريض النّاقص
Underfed = ناقص التغذية
Underfedly = بشكل ناقص التغذية
Underfeed = أنقص تغذية
Underfeeding = إنقاص تغذية
Underflow = خطأ معالجة
Underflows = يخطئ في المعالجة
Underfoot = تحت القدمين
Underframe = البنْية الدّاعمة
Undergarment = ثوْب تحتيّ
Undergarments = أثواب تحتيّة
Underget = يفهم
Undergird = يساند معنوياً
Undergirding = تقوية الأساس
Undergo = مرّ به
Undergoes = يمرّ به
Undergoing = المرور
Undergone = ممرور ب
Undergrad = الطالب الجامعي
Undergrads = الطلاب الجامعيون
Undergraduate = الطالب الجامعي
Undergraduates = الطلاب الجامعيون
Underground = تحت الأرض
Undergrounder = تحْأرضيْ
Undergrounds = تحت الأرض
Undergrowth = ضعف النمو
Underhand = خفيّ
Underhanded = يُخْفى
Underhandedly = بخفْية
Underhandedness = الخِفْية
