Unstigmatized = غير موشوم
Unstilted = غير متكلف
Unstinted = جواد :: كريم :: سخيّ
Unstinting = جبّار
Unstintingly = بشكل جبّار
Unstitched = غير مخيّط
Unstop = إفتح
Unstoppable = لايمكن إيقافه
Unstopped = مفتوح
Unstopping = الفتح
Unstops = يفتح
Unstrained = غير مقيّد
Unstrainedly = بشكل غير مقيّد
Unstrap = حلّ
Unstrapped = محلول
Unstrapping = الحلّ
Unstraps = يحلّ
Unstratified = غير مرتّب
Unstreamed = غير مجري
Unstressed = غير مشدّد
Unstressedly = بشكل غير مشدّد
Unstriated = غير مخطّط
Unstriped = غير مخطّط
Unstructured = غير منظّم
Unstrung = حلّ
Unstuck = مفصول
Unstudied = غير مدروس
Unstuff = يُخلّص من :: يفتح الإنسداد
Unstuffy = غير فاسد
Unsubdivided = أوراق الشّجر الغير مجزّئه او لا تتكوّن من أجزاء صغيرة
Unsubduable = لا يُقهر :: لا يُخضع :: لا يُهزم
Unsubdued = لا يُقهر :: لا يُخضع :: لا يُهزم
Unsubsidized = غير مدعوم
Unsubstantial = غير كبير
Unsubstantially = غير بشكل كبير جدا
Unsubstantiated = غير مؤكّد
Unsubstituted = غير مستبدل
Unsubtle = غير غير ملحوظ
Unsuccess = الفشل :: سوء الحظ :: كريهة :: مصيبة :: ملمَّة
Unsuccessful = مخفق
Unsuccessfully = بإخفاق
Unsuccessfulness = الإخفاق
Unsuccored = غير مغاث
Unsufferable = لا يُحتمل :: لا يُطاق
Unsufficiency = الحاجة :: العوز :: النّقص :: العجز
Unsufficient = غير كاف :: قاصر :: ناقص
Unsuffixed = غير ملحق
Unsuit = لا يلائم :: ذو مقاس مختلف
Unsuitability = عدم ملائمة
Unsuitable = غير ملائم
Unsuitableness = عدم الملائمة
Unsuitably = بشكل غير ملائم
Unsuited = غير ملائم
Unsullied = لا تشوبه شائبة
Unsummarized = غير ملخّص
Unsung = غير مغنّى
Unsupervised = غير مشرف عليه
Unsupportable = غير قابل للدعم
Unsupported = غير مدعوم
Unsupportedly = بشكل غير مدعوم
Unsuppressed = غير مقموع
Unsure = غير متأكد
Unsured = غير واثق :: غير متأكّد
Unsurely = بشكل غير متأكد
Unsurety = الشّك :: اشتباه :: شيء مجهول :: شيء مشكوك فيه
Unsurmountable = غير قابل للقهر
Unsurpassable = ﻻ يمكن تجاوزه
Unsurpassed = لا نظير له
Unsurprised = غير مفاجئ
Unsurprising = غير مفاجئ
Unsurprisingly = بشكل غير مفاجئ
Unsurveyed = غير ممسوح
Unsusceptibility = عدم الإحساس :: عدم القابليّة :: بطأ التّأثّر
Unsusceptible = غير سريع التأثير
Unsusceptibly = غير بشكل حساس
Unsuspected = غير معروف
Unsuspectedly = بشكل غير معروف
Unsuspecting = جاهل
Unsuspectingly = بشكل جاهل
Unsuspended = غير معلّق
Unsuspicious = غير مثير للشكّ
Unsuspiciously = غير بصورة مريبة
Unsustainable = لا يمكن دعمه
Unswallowable = غير قابل للبلع
Unsweet = مشمئز :: كريه
Unsweetened = غير محلّى
Unswept = غير كنس
Unswerving = ثابت
Unswervingly = بشكل ثابت
Unswollen = غير متورّم
Unsworn = غير مقسم
Unsymbolized = غير ممثّل
Unsymmetric = غير متّسق :: غير متماثل :: غير متناسق
Unsymmetrical = غير متماثل
Unsymmetrically = بشكل غير متماثل
Unsympathetic = غير متعاطف
Unsympathetically = غير عاطفيا
Unsympathized = غير متعاطف
Unsympathizing = غير متعاطف
Unsynchronized = غير مزامن
Unsynthesized = غير مركّب
Unsystematic = غير نظاميّ
Unsystematical = غير نظاميّ
Unsystematically = بشكل غير نظاميّ
Unsystematized = غير منظّم
Unsystematizing = غير تنظيم
Untack = إفصل
Untackle = ينزع الطقم :: ينزع العدة
Untactful = غير لبق
Untactfully = غير بلباقة
Untag = غير بطاقة
Untagged = غير معلّم
Untainted = غير ملوّث
Untalented = غير موهوب
Untamable = أنتامابل
Untamed = جامح
Untampered = غير عابث
Untangible = غير ملموس :: مجرد :: معنوي
Untangle = حلّ
Untangled = محلول
Untangles = يحلّ
Untangling = الحلّ
Untantalized = غير مثار
Untaped = غير مسجّل
Untapped = غير مستغلّ
Untarnished = غير ملوّث
Untasted = غير مذاق
Untaught = غير معلّم
Untaxed = غير مفروض عليه ضريبة
Unteach = يدرّس معلومة تناقض معلومات سابقة
Unteachable = غير قابل للتعليم
Untechnical = غير متمكّن او متمرّس في الفنون التّطبيقيّة
Untellable = ﻻ يمكن وصفه
Untempered = غير مخفّف
Unten = عشر غير
Untenable = لايمكن الدفاع عنه
Untenably = بشكل يمكن الإحتفاظ به
Untenanted = غير مستأجر
Untended = غير مُعتنى به
Untented = عاري
Unterminated = غير منهى
Unterrorized = غير مرهب
Untestable = غير قابل للفحص
Untested = لم يختبر
Untethered = غير مقيّد او محكوم بحبل
Unthankful = جاحد للجميل :: ناكر المعروف
Unthankfully = غير ممتنّ
Unthankfulness = عدم الامتنان
Unthaw = يذيب الجليد :: يتحوّل الى سائل او ليّن
Unthawed = متجمّد :: لم يذب عنه الجليد
Untheatrical = غير مسرحي
Unthematic = غير موضوعي
Unthinkable = مستحيل
Unthinkably = بشكل غير وارد
Unthinking = الغفل
Unthinkingly = بشكل مغفول
Unthought = غفل
Unthrifty = غير مقتصد
Untidier = غير مرتّب
Untidiest = غير مرتّب
Untidily = بشكل غير مرتّب
Untidiness = عدم الترتيب
Untidy = غير مرتّب
Untie = حلّ
Untied = محلول
Unties = يحلّ
Until = حتى
Untile = يزيل البلاط :: يكشف الأرض عن طريق إزالة البلاط
Untill = غير درج نقود
Untilled = غير محروث
Untime = في الوقت الغير مناسب :: في غير أوانه :: غير مرغوب فيه :: غير مألوف
Untimeliness = سبق الأوان
Untimely = سابق لأوانه
Untimeous = في غير أوانه :: قبل الأوان :: مبكر
Untinged = غير مخلوط
Untirable = ﻻ يمكن ارهاقه
Untiring = مثابر
Untiringly = بشكل مثابر
Untitled = غير ملقّب
Unto = إلى
Untold = لم يسمع به من قبل
Untoldly = بشكل لم يسمع به من قبل
Untolerable = لا يحمل :: لا يطاق :: مفرط
Untorn = غير ممزّق
Untouchable = المحصّن
Untouchables = المحصّنون
Untouchably = فوق النقد
Untouched = غير متأثّر
Untoward = غير متوقّع
Untowardly = بشكل غير متوقّع
Untowardness = الفجائيّة
Untraceable = غير قابل للتقصّي
Untraceably = غير بشكل قابل للتقصّي
Untraced = غير متتبّع
Untracked = غير متعقّب
Untraditional = غير تقليدي
Untrained = غير مدرّب
Untrammeled = غير مقيّد
Untrammelled = غير محدود :: غير مقيّد
Untransferable = غير قابل للتحويل
Untransferred = غير محوّل
Untransformed = غير تحوّل
Untranslatable = غير قابل للترجمة
Untranslated = غير مترجم
Untransposed = غير منقول
Untraveled = غير مستخدم للسفر
Untread = عد
Untreated = غير معالج
Untried = غير مجرّب
Untriedly = بشكل غير مجرّب
Untrimmed = أشعث :: أشعر :: فظ
Untrod = غير داس
Untrodden = غير مداس
Untroubled = غير متأثّر
Untroubledly = بشكل غير متأثّر
Untrowable = لا يُصدق :: مستبعد جداً
Untrue = غير صحيح
Untruely = بشكل غير صحيح
Untruly = بكذب
Untrusted = غير مؤتمن
Untrusting = لايثق بالنّاس :: غير موثوق به
Untrustworthiness = غير أهل للثقة
Untrustworthy = غير موثوق
Untrusty = غير وفي
Untruth = الكذبة
Untruthful = كاذب
Untruthfully = بشكل كاذب
Untruthfulness = عدم المصداقيّة
Untruths = الكذب
Untuck = يفتح شيئاً مطوياً كالسّجادة او اللحاف
Untune = يفسد تقسيم الآلة الموسيقيّة :: يجعل الآلة الموسيقية تنشّز
Untuned = مشوّش
Untuneful = بلا صوت موسيقي :: نشاز
Unturned = غير مقلوب
Untutored = غير دارس
Untwine = يفكّ المتشابك :: يفكّ المتحابك
Untwirl = يحلّ :: يفكّ
Untwist = حلّ
Untwisted = محلول
Untwisting = الحلّ
Untwists = يحلّ
Unty = انحل :: انفك :: حلّ :: فكّ :: يحل :: يسلّك :: يفك
Untying = الحلّ
Untyped = غير مطبوع
Untypical = غير نموذجي
Untypically = بشكل غير نموذجي
Ununderstood = غير مفهوم :: غير واضح :: مبهم
Unusable = غير صالح للإستعمال
Unuseable = غير صالح للإستعمال
Unused = غير مستعمل
Unusual = غير عادي
Unusually = بشكل غير إعتيادي
Unusualness = النّدرة
Unutilized = غير مستعمل
Unutterable = لا يوصف
Unutterably = بشكل لا يوصف
Unuttered = غير منطوق
Unvaccinated = غير ملقّح
Unvail = يكشف النقاب عن :: يميط اللثام
Unvaluable = نفيس :: ثمين :: لا يعادله شيء :: لا يقدر بثمن
Unvalued = غير مقيّم
Unvanquishable = لا يُقهر :: لا يُهزم
Unvanquished = غير مقهور
Unvariable = غير متغيّر
Unvaried = غير مختلف
Unvarnished = بدون تزويق
Unvarnishedly = بشكل بدون تزويق
Unvarying = ثابت
Unvaryingly = بشكل ثابت
Unveil = إكشف
Unveiled = مكشوف
Unveiling = الكشف
Unveils = يكشف
Unvented = غير منفّس
Unventilated = غير مهوّى
Unveracity = إنتفاء الصّحة في الكلام :: بلا دقّة :: بلا صِدْق
Unverbalized = غير مفعّل
Unverifiable = غير قابل للإثبات
Unverified = غير محقّق
Unversed = غير متمكن :: غير مُلم :: غير متمرّس
Unversedly = بشكل جاهل
Unvexed = غير عويص
Unvictimized = غير ظلم
Unvindicated = غير مبرّأ
Unviolated = غير مخدوش :: مُصان :: لم ينتهك
Unvisited = غير مزار
Unvisualized = غير متصوّر
Unvitiated = بتولي :: بحت :: أصيل :: خالص :: طاهر
Unvocalized = غير ملفوظ
Unvoiced = صامت
Unvoluntary = لا إرادي
Unvulcanized = غير معالج بالكبريت
Unwaged = غير مأجور
Unwanted = غير مرغوب
Unwantedly = بشكل غير مرغوب
Unwarily = بشكل غافل
Unwariness = الغفلة
Unwarm = بلا دفىء :: بارد
Unwarmed = غير مدفّأ
Unwarrantable = لا مبرّر له
