Vanilla = الفانيلا
Vanillin = ونيلين
Vanir = سباق الآلهة. أساطير إسكندنافيّة
Vanish = إختف
Vanished = مختفى
Vanisher = اِحْتَجَبَ اِخْتَبَأَ
Vanishes = يختفي
Vanishing = الإختفاء
Vanishingly = بزوال
Vanities = حالة ألشعور بالفراغ
Vanity = الزهو، الغرور
Vanner = الشّخص الذي يمتلك سيّارة فان
Vannevar = تنبّؤ تكنولوجيّ زائف
Vanning = التّنقّل بواسطة سيارة فان
Vanquish = إقهر
Vanquished = مقهور
Vanquisher = قَهَّار
Vanquishers = قَهَّار
Vanquishes = يقهر
Vanquishing = القهر
Vans = الشاحنات
Vant = يتكلّم بتفاخر، تفاخر، يتفاخر
Vantage = الفضل
Vantages = الأفضال
Vanuatu = فانواتو
Vanward = أمام او بمواجهة السّيّارة الـ فان
Vap = مملّ، عديم الطعم، بلا حياة
Vapid = مملّ
Vapidity = التفاهة
Vapidly = بشكل مملّ
Vapidness = سَلِيخ مَسِيخ
Vapor = البخار
Vaporable = ممكن تبخيره بواسطة معامل التّبخرة كالحرارة
Vaporation = التّبخير، تحويل السّائل الى بخار
Vapored = دُخَّان
Vaporer = ألقائم بعملية التبخير
Vaporers = ألقائم بعملية التبخير
Vaporing = تبخير
Vaporingly = بتَبَجُّح
Vaporings = تبخير
Vaporisation = التّبخرة، تحوّل السّائل الى بخار
Vaporizable = ممكن تحويله الى بخار
Vaporization = تَبَخُّر تَبْخِير
Vaporizations = تَبَخُّر تَبْخِير
Vaporize = بخّر
Vaporized = مبخّر
Vaporizer = المبخر
Vaporizers = المبخر
Vaporizes = يبخّر
Vaporizing = التبخير
Vaporous = بخاري
Vaporously = بشكل بخاري
Vapors = الأبخرة
Vaporware = برنامج الكمبيوتر الذي أُعْلِن عنه ولكن لم يتمّ إنتاجه
Vapory = بخاري الحالة، مملوء بالبخار
Vapour = البخار
Vapours = الأبخرة
VAR = بائع ذو خدمات اضافية على البضاعة اﻷصلية
Vapulation = الضّرب او الخفق
Vaquero = راعي البقر
Vara = وحدة طول أسبانيّة. حوالي ياردة
Varan = فاران - حيوان زاحف مفترس
Vare = العرسة
Varec = عشب البحر
Vari = فاري - قرد ليموري
Variability = التغيّر
Variable = المتغيّر
Variableness = تَقَلُّب
Variablenesses = ألتقلب
Variables = المتغيّرات
Variably = بشكل متغيّر
Variac = محوّل
Varian = فاريان
Variance = الخلاف
Variances = الخلافات
Variant = المغاير
Variantly = بشكل مختلف
Variants = المغايرات
Variate = نوّع
Variated = منوّع
Variates = ينوّع
Variating = التنويع
Variation = الإختلاف
Variational = متعلق بالتّغير او الإختلاف او التّباين
Variations = الإختلافات
Varicella = جديري الماء
Varices = عروق الدّم الملتوية أو المتورّمة بصورة غير طبيعية، الدّوالي
Varicocele = العروق المتورّمة في كيس الصّفن
Varicolored = مُتَلَوِّن
Varicoloured = متعدد الألوان
Varicose = دوالي
Varicoses = دوالي
Varicosis = الدّوالي، أوعية دمويّة متورّمة
Varicosities = انتفاخات
Varicosity = انتفاخ
Varied = مختلف
Variedly = بتفاوت
Variegate = لوّن
Variegated = متنوّع
Variegates = يلوّن
Variegating = التلوين
Variegation = تَشْكِيل نَقْش
Varier = هائم
Varies = يتفاوت
Varietal = متباين، متنوّع
Varietas = التّشكيلة
Varieties = التنويعات
Variety = التشكيلة
Variform = متعدد الأشكال
Varify = يباين، يجعله مختلف، يلوّن
Variola = الجدريّ
Variole = الكتلة الصّخرية المستديرة
Variorum = الطّبعة من الكتاب التي تحتوي على تعليقات وملاحظات ثلّة من الأدباء
Various = مختلف
Variously = بشكل مختلف
Variousness = اِخْتِلاف
Varistor = مُكثِّف
Varitype = يطبع
Varix = عروق الدّم الملتوية أو المتورّمة بصورة غير طبيعية
Vark = خنزير
Varlet = أَلْكَع زَنِيم
Varlets = أَلْكَع زَنِيم
Varment = الحيوان البرّيّ المفترس الغير مرغوب فيه. على سبيل المثال ابن آوى
Varmint = اللئيم
Varmints = اللئيمون
Varna = مدينة فارنا البلغاريّة
Varnish = الصبغ
Varnished = ملمّع
Varnisher = ألد هان
Varnishers = ألدهانون - جمع دهان
Varnishes = الأصباغ
Varnishing = التلميع
Varsities = الجامعات
Varsity = الجامعة
Varuna = الإله الخالق الهندوسي
Varus = التّقوّس، معقوف للداخل
Varvel = الحلقة التي توثق أرجل الصّقر بيد المدرّب
Vary = تفاوت
Varying = التفاوت
Varyingly = باختلاف
Varyings = مُتَغَيِّر مُتَقَلِّب
Vas = الوريد في جسم الإنسان او الحيوان
Vasa = الأوردة في جسم الإنسان او الحيوان
Vascula = الصّناديق
Vascular = وعائي
Vascularity = الوعائيّة، الإحتوائيّة
Vascularly = بشكل وعائي
Vasculitis = التهاب الأوعية الدّمويّة
Vasculum = الصّندوق
Vase = الزهرية
Vasectomies = عمليات جراحية تمنع انتاج الحيوانات المنوية
Vasectomy = عملية جراحية تمنع انتاج الحيوانات المنوية
Vaselin = مرهم الفاسيلين
Vaseline = الفازيلين
Vases = الزهريات
Vashti = فاشتي
Vasiform = بصورة اسطوانية
Vasoconstriction = انقباض الأوعية الدّمويّة مما يقلل من تدفق الدم في الجسم
Vasoconstrictor = دواء او مسبب لتقلّص الأوعية الدموية
Vasodilation = توسيع الأوعية الدّمويّة
Vasodilator = الدّواء الذي يسبّب توسيع الأوعية الدّمويّة
Vasomotor = مؤثر على قطر الأوعية الدّمويّة
Vasopressin = فاسوبريسين - الهرمون الذي يرفع ضغط الدّم
Vasquez = فاسكويز
Vass = مدينة فاس
Vassal = التابع
Vassalage = قَطِيعَة
Vassals = التوابع
Vassar = فاسار
Vast = واسع
Vastation = الخسارة، نزع السّكّان، التّدمير
Vaster = أوسع
Vastest = أوسع
Vastitude = الاتّساع، المدًى الكبير
Vastity = الاتّساع
Vastly = بشكل واسع
Vastness = السعة
Vastnesses = السعة
Vasty = شاسع، كبير
Vasum = فاسم - حيوان بحري بطني الأقدام ذو صدفة على كمّثريّة الشّكل
Vat = الحوض
Vatia = مدينة فاتيا
Vatic = متعلق بالنبي ونبوأته او رسالته
Vatical = متعلق بالنبي ونبوأته او رسالته
Vatican = الفاتيكان
Vaticide = القتل أو قاتل النبيّ
Vaticinate = يتّنبّأ بشيئ ما
Vaticination = معرفة المستقبل وعلم الغيب
Vaticinator = الذي يخمّن المستقبل
Vats = الأحواض
Vatted = وضع أو نقل في برميل
Vatting = الوضع أو النّقل في برميل
Vaudeville = الإستعراض المسرحي
Vaudevilles = الإستعراضات المسرحية
Vaudevillian = الممثل الذي يعمل في المنوّعات و الإستعراض المسرحي
Vaudois = سكان اقليم فود السويسري
Vaughan = فآن
Vaughn = فان
Vault = المدفن
Vaulted = مقبّب
Vaulter = المسؤول عن القبو
Vaulting = التقبيب
Vaults = المدافن
Vaulty = فسيح، واسع
Vaunt = التفاخر
Vaunted = متبجّح
Vaunter = المتبجح
Vaunting = التبجّح
Vauntingly = بطريقة متفاخرة
Vaunts = التفاخر
Vaut = الفسيح، القفزة، يقفز
Vauty = قفز
Vauxhall = مدينة فوكسهول
Vavasor = لقب تشريف يوازي تشريف لقب البارون
Vavasour = الإقطاعيّ الذي تمّ تصنيفه مباشرةً تحت مرتبة بارون
Vaward = المقدّمة، الجزء الأمامي
Vax = ميني كومبيوتر
VCR = جهاز فيديو
Vaxectomy = استئصال او إزالة جهاز فاكس VAX
Vayu = إله الرّيح لدى الهندوس
Vd = المرض الجنسيّ
Vdt = شاشة كمبيوتر
Vdu = شاشة كمبيوتر
Ve = ف
Veal = لحم العجل
Vealer = العجل المربى للأكل
Veau = لحم  العجل
Veblen = فيبلين - عالم رياضيّات من الولايات المتّحدة
Vection = العدوى، إنتقال المرض من شخص الى آخر
Vector = الموجه
Vectored = مُوجَّه
Vectorial = إتّجاهي
Vectoring = توجيه
Vectorization = كَمِّيَّةٌ مُوَجَّهَة
Vectorizing = كَمِّيَّةٌ مُوَجَّهَة
Vectors = الموجهات
Vecture = إنتقال العدوى
Veda = الفيدا
Vedanta = مدرسة الهندوسيّة
Vedantic = متعلّق بالمدرسة الهندوسيّة
Vedette = الزّورق
Vedic = متعلق بديانة الفيدا الهنديّة
Vedro = فيدرو - وحدة مقياس سائل روسيّ
Vee = في
Veep = نائب الرئيس
Veeps = نائبوا الرؤساء
Veer = إنحرف
Veered = منحرف
Veeries = عصافير فيري
Veering = الإنحراف
Veeringly = اِنْحِرَاف
Veers = ينحرف
Veery = عصفور فيري
Vega = نجم فيجا
Vegan = النّباتي
Vegas = فيجاس
Vegetable = الخضار
Vegetables = الخضار
Vegetal = نباتي
Vegetarian = نباتي
Vegetarianism = الريجيم النباتي
Vegetarians = النباتيون
Vegetate = إنبت
Vegetated = مزروع
Vegetates = ينبت
Vegetating = النبتة
Vegetation = النباتات
Vegetational = يتكوّن من النّباتات
Vegetations = النباتات
Vegetative = زراعي
Vegetatively = بشكل زراعي
Vegetativeness = القابلية على النّمو والإثمار
Vegete = نشيط،  شاقّ
Vegetous = شاقّ، نشيط
Veggie = الخضروات، الشّحخص النّباتي
Vehemence = العنف
Vehemences = العنف
Vehemency = العنف
Vehement = عنيف
Vehemently = بشكل عنيف
Vehicle = العربة
Vehicled = نقل في مركبة،  مزوّد بمركبة
Vehicles = العربات
Vehicular = خاص بالعربات
Veil = الحجاب
Veiled = محجّب
Veiling = نسيج البراقع
Veilings = نسيج البراقع
Veils = الأحجبة
Vein = العرق
Veinal = وريدي، متعلق بالوريد
Veined = كثير العروق
Veiner = أدات حفر الخشب
Veining = التعرّق
Veinless = بلا عروق
Veinlet = عرق صغير
Veinous = بارز العروق
Veins = العروق
Veiny = ممتلئ بالعروق
Vel = إختصار لكلمة السّرعة
