Wafered = مرقّق
Wafering = الرّق
Wafers = بسكويتات الويفر
Waffle = الهراء
Waffled = مهذور
Waffles = بسكويتات الوفل
Waffling = الهراء
Waft = النسمة
Wafted = مهبوب
Wafter = المُنبعث
Wafting = الهبوب
Wafts = النسمات
Wafture = التلويح باليد
Wag = المهرّج
Wage = الأجر
Wage-earner = الأجير
Wage-price = سعر أجر
Waged = مشنون
Wagel = صغار طائر النّورس ذو الظهر الأسود
Wager = الرهان
Wagered = مراهن
Wagerer = الآجر
Wagering = المراهنة
Wagers = الرهان
Wages = الأجور
Wages-earner = أجير
Wagged = مهزوز
Waggel = صغار طائر النّورس ذو الظهر الأسود
Waggery = المزحة
Wagging = الهزّ
Waggish = هزلي
Waggishly = بشكل هزلي
Waggishness = الهزل
Waggle = هزّ
Waggled = مهزوز
Waggles = يهزّ
Waggling = الهزّ
Waggly = بهزّ
Waggon = العربة
Waggoner = سائق العربة
Waggoners = سائقوا العربات
Waggons = العربات
Waging = الشنّ
Wagner = واجنر
Wagnerian = مرتبط بريتشارد واجنر
Wagon = العربة
Wagoneer = مرتبط بريتشارد واجنر
Wagoner = سائق العربة
Wagoners = سائقوا العربات
Wagoning = التّنقّل بالحنطور
Wagons = العربات
Wagonwright =  صانع الحنطور
Wags = المهرجون
Wagtail = الذعرة
Wagtails = الذعرات
Wah = الباندا
Wahaby = الوهّابي، من يتبع محمد بن عبدالوهاب
Wahl = وال
Wahoo = شجيرة الواهو
Wahvey = الله
Waid = سحق
Waif = الشارد
Waifs = الشوارد
Waift = المتشرّد
Wail = نُح
Wailed = ناحَ
Wailer = نائح
Wailful = نائح
Wailfully = بنواح
Wailing = النواح
Wailingly = بطريقة نواحيّة
Wails = العويل
Wain = عربة مزرعة
Wains = عربات مزرعة
Wainscot = كسوة خشبية
Wainscoted = مكسُوّ بالخشب
Wainscoting = الكساء بالخشب
Wainscots = كسوات خشبية
Wainscotting = ألواح خشبيّة لتغطية جدران الغرفة
Wainwright = صانع العربة
Wais = خادم لجلب المعلومات
Waist = الخصر
Waistband = حزام
Waistbands = أحزمة
Waistcoat = الصدرية
Waistcoated = مغطى بصدرية
Waistcoats = الصدريات
Waisted = مُخصّر
Waister = مخصِّر
Waistline = حدّ الخصر
Waistlines = حد الخصر
Waists = الخصور
Wait = إنتظرْ
Waite = وايت
Waited = انتظرَ
Waiter = النادل
Waiters = النوادل
Waiting = الإنتظار
Waitress = النادلة
Waitresses = النادلات
Waits = ينتظر
Waive = إترك
Waived = متروك
Waiver = التنازل
Waivers = التنازلات
Waives = يترك
Waiving = الترك
Wake = الصحوة
Wake-up = إستيقظ
Waked = إستيقظ
Wakefield = ويكفيلد
Wakeful = متأرّق
Wakefully = بشكل متأرّق
Wakefulness = إنعدام النوم
Wakeless = النّوم العميق
Waken = أيقظ
Wakened = موقظ
Wakener = موقظ
Wakening = الإيقاظ
Wakens = يوقظ
Waker = المستيقض
Wakes = الصحوة
Waketime = الإفاقة، اليقضة
Wakeup = تنبيه الإيقاظ
Wakf = الوقف من العقار
Waking = الإستيقاظ
Wakita = مدينة واكيتا
Walbridge = والبردج
Walcott = والْكوتّ
Wald = أحراش، غابة
Walden = والدن
Waldenses = فرقة من فرق المسيحية
Waldensian = والدينسيان
Waldmeister = ورق شجر معطر يستخدم لتطييب النّبيذ
Waldo = والدو
Waldorf = والدورف
Waldron = والدرون
Wale = علامة
Waled = مُعلَّم
Waler = وايلر
Wales = علامات
Walford = والفورد
Walgreen = والجرين
Walhalla = مكان تجمع الأبطال القتلى خلال المعركة في حياة البرزخ
Waling = تحديد
Walk = المشي
Walk-on = يلعب دوراً صغيراً في المسرحيّة
Walk-up = عمارة بلا مصعد كهربائي
Walkable = ممكن السّير عليه
Walkabout = رحلة على الأقدام
Walkaway = الفوز اليسير
Walked = ممشي
Walker = الماشي
Walkers = المشاة
Walkie-talkie = راديو ﻻسلكي
Walkie-talkies = راديوهات ﻻسلكية
Walking = المشي
Walkon = يلعب دوراً صغيراً في المسرحيّة
Walkout = الإنسحاب
Walkouts = عمليات الخروج
Walkover = يسير
Walks = المشي
Walkthrough = تجول خﻻل
Walkway = مسار
Walkways = مسارات
Wall = الحائط
Wall-eye = سمكة الوول آي
Wall-eyed = بعين ذات لون رمادي
Wall-to-wall = كامل
Walla = المسؤول
Wallabee = الكنغر
Wallabies = الكنيغرات
Wallaby = الكنيغر
Wallace = والاس
Wallachian = متعلق بـ والاشين - إقليم تاريخي في جنوب شرق رومانيا
Wallack = متعلق بـ والاشين - إقليم تاريخي في جنوب شرق رومانيا
Wallah = المسؤول
Wallaroo = الكنغر
Wallboard = ورق الحائط
Walled = محاط
Wallenstein = والينشتاين
Waller = والر
Wallet = المحفظة
Wallets = المحافظ
Walleye = العين رماديّة فاتحة اللون
Walleyed = ذو عين رمادية فاتحة اللون
Walleyes = عيون رمادية فاتحة اللون
Wallflower = المنثور
Wallflowers = المنثور
Wallies = سخفاء
Walling = التّحويط
Wallis = واليس
Wallon = الوالون
Walloon = والوون - من أحد اللهجات الفرنسية
Walloons = القوميّة الرّومانية التي تقطن بعض أجزاء بلجيكا
Wallop = الصفعة
Walloped = صفع
Walloper = شديد الصفعة
Walloping = الأزيز
Wallops = الصفعات
Wallow = التمرّغ
Wallowed = متمرّغ
Wallower = متمرّغ
Wallowers = متمرّغون
Wallowing = التمرّغ
Wallows = يتمرّغ
Wallpaper = ورق الجدران
Wallpapered = مغطّى بورق الجدران
Wallpapering = التغطية بورق الجدران
Wallpapers = أوراق الجدران
Walls = الحوائط
Wally = والي
Walm = يتفاقم، يتدحرج، يتدفّق
Walnut = الجوزة
Walnuts = الجوز
Walpole = والبول
Walpurgis = والبروجيس - مبشّر إنجليزي
Walrus = الفظّ
Walruses = حيوانات الفظّ
Walsh = والش
Walt = والت
Walter = والتر
Walters = والترز
Waltham = والتايم
Walton = والتن
Waltz = الفالز
Waltzed = راقص الفالز
Waltzer = راقص الفالز
Waltzes = رقصات الفالز
Waltzing = رقص الفالز
Walum = مدينة والم
Walworth = والورث
Waly = تستخدم للتعبير عن الحزن
Walzed = رقص الفالز
Wamac = مدينة واماك
Wamble = ترنّح
Wamic = مدينة واميك
Wammel = ترنّح
Wamp = نوع من البط
Wampum = خرز الزّينة كنقود من قبل الهنود الحمر
Wan = الشبكة الواسعة النطاق
Wana = مدينة وانا
Wand = الصولجان
Wanda = مدينة واندا
Wandala = لغة الواندالا المستخدمة في الكاميرون
Wander = تجوّل
Wandered = متجوّل
Wanderer = الهيّام
Wanderers = الهيّامون
Wandering = التجوّل
Wanderings = الرحلات
Wanderlust = حبّ السفر
Wanders = يتجوّل
Wando = مدينة واندو
Wands = الصولجانات
Wane = التناقص
Waned = متضاءل
Wanes = التناقص
Waney = حافّة وعرة أو حادّة على لوحة
Wang = وانج
Wangan = قارب
Wanger = المخدّة
Wangle = الإحتيال
Wangled = مغشوش
Wangler = مكّار
Wanglers = مكّارون
Wangles = المكْر
Wangling = المكْر
Wango = البووميرانج
Wangun = قارب، صندوق عدّة، بيت صغير
Waning = التضاءل
Wank = العادة السّرّيّة، الإستمناء باليد
Wankel = وانكل
Wankle = غير مستقر، لايمكن الإعتماد عليه
Wanly = بشكل شاحب
Wann = مدينة وان
Wannabe = شخص يتوق ان يصبح شخص اخر، المتمنّي
Wannabee = شخص يتوق ان يصبح شخص اخر، المتمنّي
Wanned = شحب لونه
Wanness = الشّحب
Wannish = شاحب نوعاً ما
Wansley = وانسلي
Want = الحاجة
Wantage = النّقص
Wanted = مطلوب
Wanter = المحتاج
Wanting = الطلب
Wanton = الخليع
Wantoned = تكلّم او تصرّف بلا سبب او مبرر، عبث، إستهتر
Wantoner = عشوائي
Wantoning = الخﻻعة
Wantonly = بعشوائية
Wantonness = العشوائية
Wantons = الخليعون
Wants = الحاجات
Wanty = رباط مصنوع من الجلد
Wany = ضَعُفَ
Wap = الضّربة، ضرب
Wapato = واباتو
Wapentake = تقسيم تاريخيّ لبعض المقاطعات
