Boilermaker = الصانع غلاّيات
Boilermakers = الصانع غلاّيات
Boilerplate = بويليربليت
Boilers = الغلّايات
Boiling = الغليان
Boils = الغليان
Boise = بويزي - عاصمة ولاية أيداهو
Boisterous = مزعج
Boisterously = بصخب
Boisterousness = الإزعاج
Boisterousnesses = الصخب
Boking = التقيّأ
Bold = اجترئ
BoldComment = ملاحظة عريضة
Bolder = أجرأ
Boldest = الأجرأ
Boldface = الخطّ الكبير
Boldfaced = بأحرف كبيرة
Boldfaces = بولدفاسيس
Boldfacing = طبع بحروف ثخينة
Boldly = بجرأة
Boldness = الجرأة
Boldnesses = الصراحة
Bole = الجذع
Boles = الجذوع
Boletus = البوليطس
Boletuses = البوليطس
Bolivar = بوليفار
Bolivia = بوليفيا
Boll = الكيس
Bolo = السّكّين
Bologna = بولونيا
Bolometer = البولومتر
Bolometers = البولومترات
Bolos = السّكاكين
Bolshevik = البلشفيّ
Bolsheviks = البلشفيّون
Bolshevism = البلشفيّة
Bolshevist = البلشفيّ
Bolshevistic = تعلّق بالبلشفية
Bolshoi = بولشوي
Bolster = الوسادة
Bolstered = دعّم
Bolsterer = مساند، مؤيد
Bolstering = التّدعيم
Bolsters = الوسائد
Bolt = التّرباس
Bolted = اندفع
Bolter = ماكنة لفصل النخالة من الطحين، المنخل
Bolting = الاندفاع
Bolton = بولتون
Bolts = التّرابيس
Boltzmann = بولتزمان
Bolus = القرص
Boluses = الأقراص
Bomb = القنبلة
Bombard = اقصف
Bombarded = قصف
Bombardier = الجنديّ
Bombarding = القصف
Bombardment = القذف
Bombardments = القذف
Bombards = يقصف
Bombast = كلام منمّق
Bombaster = ذو كلام منمّق طنّان
Bombastic = منمّق
Bombastically = بشكل منمّق
Bombasts = بومباستس
Bombay = بومباي
Bombed = قصف
Bomber = منفذ العملية
Bombers = القاذفات
Bombing = القصف
Bombings = القصف
Bombproof = محصّن ضدّ القنابل
Bombs = القنابل
Bon = بون
Bona = جيّد
Bonanza = الصّفقة
Bonanzas = الصّفقات
Bonaparte = بونابارت
Bonaventure = بونافنتشر
Bond = السّند
Bondage = التّعذيب
Bonded = التصق
Bonder = الذي يضع السلع تحت الايداع أو في مستودع مضمون
Bondholder = حامل السّند
Bonding = العلاقة
Bonds = السّندات
Bondsman = الضّامن
Bondsmen = الضّامنون
Bone = العظمة
Boned = صلب
Bonelazy = كسول
Boneless = بلا عظام
Bonemeal = السّماد
Boner = الخطأ
Boners = الأخطاء
Bones = العظام
Bonfire = النّار
Bonfires = النّيران
Bong = الرّنين
Bongo = الطّبلة
Bonham = بونهام
Bonhomie = الألفة
Bonier = أكثر هزالاً
Boniface = المالك
Boning = قطعة العاج
Bonito = البينيت
Bonjour = صباح الخير
Bonk = يضرب، يتصل جنسيا
Bonn = بون
Bonnet = الغطاء
Bonneted = انحنى
Bonnets = الأغطية
Bonneville = بونفيل
Bonnie = بوني
Bonnier = أجمل
Bonnily = بصورة جميلة
Bonniness = أن تكون جميل أو جميلة
Bonny = جميل
Bontempo = بونتمبو
Bonus = المكافأة
Bonuses = المكافآت
Bony = هزيل
Bonze = الرّاهب
Boo = البوو
Boob = الخطأ
Boobed = ارتكب حماقة
Boobies = المغفّلون
Booboo = الخطأ
Boobs = الثّدي
Booby = المغفّل
Booed = صاح مزدريًا
Boogie = الرّقصة
Boohoo = بوهو
Boohooed = بكى
Booing = صياح مزدريًا
Book = الكتاب
Bookbinder = المجلّد
Bookbinderies = أماكن تجليد الكتب
Bookbinders = المجلّدون
Bookbindery = تجليد الكتاب
Bookbinding = التّجليد
Bookcase = خزانة الكتب
Bookcases = خزائن الكتب
Booked = حجز
Bookend = المسند
Bookends = المساند
Booker = بوكير
Bookie = المراهن
Bookies = المراهنون
Booking = الحجز
Bookings = الحجوزات
Bookish = نظريّ
Bookishly = نظريًّا
Bookishness = اهتمام بالأفكار النّظريّة
Bookkeeper = كاتب الحسابات
Bookkeepers = كتبة الحسابات
Bookkeeping = المحاسبة
Booklet = الكتيّب
Booklets = الكتيّبات
Bookmaker = المراهن
Bookmaking = صناعة الكتب
Bookman = العالم
Bookmark = المؤشّر، العلامة، عنوان موقع مفضّل على الإنترنت
Bookmarks = الشّرائط
Bookmobile = المكتبة المتنقّلة
Bookplate = الكارت
Bookplates = الكروت
Books = الكتب
Bookseller = بائع الكتب
Booksellers = باعة الكتب
Bookshelf = الرّفّ
Bookshelves = الرّفوف
Bookshop = المكتبة
Bookshops = المكتبات
Bookstall = الكشك
Bookstore = المكتبة
Bookstores = المكتبات
Bookworm = المثقّف
Bookworms = المثقّفون
Booky = مثقّف
Boolean = منطقي
Booleans = منطقيات
Boom = الانتعاش
Boomed = دوّى
Boomer = العامل
Boomerang = الحلقة
Boomeranged = انقلب
Boomeranging = بوميرانجينج
Boomerangs = الحلقات
Booming = الدّويّ
Booms = الانفجارات
Boomtown = المدينة المزدهرة
Boomtowns = المدن المزدهرة
Boon = النّعمة
Boondocks = الأماكن النّائية
Boondoggle = يقوم بعمل تافه
Boone = بون
Boonly = بشكل مرح
Boons = النّعم
Boor = الوقح
Boorish = فظّ
Boorishly = بصورة فظّة
Boorishness = الفظاظة
Boors = الوقحون
Boos = البوو
Boost = الدّافع
Boosted = زاد
Booster = الجرعة المنشّطة
Boosterism = نصْرة التحمّس
Boosting = الزّيادة
Boosts = الدّفعات
Boot = الحذاء
Boot loader = مُحمّل نظام التشغيل
Boot-Image = صورة الحذاء
Bootable = قابل للتّشغيل
Bootblack = ماسح الأحذية
Bootblacks = ماسحون الأحذية
Booted = مرتدي حذاء
Bootes = بوتيس - برج شمالي (فلك)
Booth = الكشك
Boothes = الكشك
Booths = الأكشاك
Booties = الجوارب
Booting = الرّكل
Bootjacks = خالعات الأحذية
Bootlace = الرّباط
Bootle = بوتل
Bootleg = روّج خمور
Bootlegged = روّج خمور
Bootlegger = مروّج الخمور
Bootleggers = مروّجون الخمور
Bootlegging = الغشّ
Bootlegs = يروّج خمور
Bootless = غير مجدي
Bootlick = تملّق
Bootlicked = تملّق
Bootlicker = المنافق
Bootlicking = التّملّق
Bootlicks = يتملّق
Boots = الأحذية
Bootstrap = ألبس الحذاء
Bootstrapped = ألبس الحذاء
Bootstrapping = إلباس الحذاء
Bootstraps = يلبس الحذاء
Booty = الغنيمة
Booze = البوظة
Boozed = أسرف في الشّراب
Boozer = البار
Boozes = البوظة
Boozily = ثملاً
Boozing = إسراف في الشّراب
Boozy = ثمل
Bop = البوب
Bopping = الرّقص
Boracic = يحتوي على البورون
Borate = البورات
Borated = معالج بالبورات
Borates = البورات
Borax = البوركس
Bord = بورد
Bordeaux = البوردو
Bordello = بيت الدّعارة
Bordellos = بيوت الدّعارة
Borden = بوردين
Border = الحدود
Border-only = الحدود فقط
Border-punched = ملكوم بالحدود
Bordered = حدّ
Borderer = مقيم على الحدود
Bordering = الحداد
Borderland = منطقة الحدود
Borderlands = مناطق الحدود
Borderless = بلا حدود
Borderline = الحدّ
Borders = الحدود
Borderzone = المنطقة الفاصلة
Bore = اثقب
Borealis = شماليّ
Boreas = الريح الشمالية
Bored = ثقب
Boredom = الملل
Boredoms = السأم
Borehole = الحفرة
Borer = الحفّار
Borers = الحفّارون
Bores = المملّون
Borg = بورج
Boric = بوريك
Boring = الثّقب
Boringly = على نحو مملّ
Boringness = البلادة المتطرّفة
Boris = بوريس
Borland = بورلاند
Born = مولود
Borne = الكنبة
Borneo = بورنيو
Borns = بورنز
