Ceremoniousness = الرّسميّة
Ceremony = المراسم
Ceres = يشمّع
Cereus = سيريس - جنس نباتات لعائلة الصّبّار
Cerise = كرزي
Cerium = السيّريوم - عنصر في الجدول الدوري (كيمياء)
CERN = المختبر اﻷوروبي لفيزياء الجزيئات
Certain = متأكّد
Certainly = بالتأكيد
Certainties = الحقائق
Certainty = اليقين
Certifiable = قابل للتّصديق
Certifiably = قابلا للتّصديق
Certificate = الشهادة
Certificated = مصدّق
Certificates = الشهادات
Certificating = للتّحقّق أو الضمان بشّهادة
Certification = الشهادة
Certifications = الشهادات
Certified = مصدّق
Certifier = الذي يصدّق أو يؤكّد
Certifiers = الذين يصدّقون أو يؤكّدون
Certifies = يشهد
Certify = إشهد
Certifying = الشهادة
Certiorari = الأمر القضائيّ
Certitude = اليقين
Certitudes = اليقين
Cerulean = أزرق
Cervical = عنقي
Cervix = العنق
Cervixes = الأعناق
Cesare = قيصر
Cesarean = قيصري
Cesium = السيزيوم
Cessation = التوقف
Cessations = التوقفات
Cession = التخلي
Cessions = التخلي
Cessna = السيسنا
Cesspool = البالوعة
Cetus = القيطس - مجموعة نجوم كبيرة على خطّ الاستواء
Ceylon = سيلان
Cf = عنصر مشعّ
Chablis = النّبيذ الفرنسيّ الأبيض
Chad = تشاد
Chadwick = تشادويك
Chafe = الإنزعاج
Chafed = غضب
Chafer = الجعل (حشرة)
Chafers = الجعل
Chafes = يغضب
Chaff = القشر
Chaffer = المساومة
Chaffered = مساوم
Chafferer = المساوم
Chaffering = المساومة
Chaffinch = الشرشور
Chaffinches = الشرشور
Chaffing = الممازحة
Chaffs = يمازح
Chafing = الغضب
Chagrin = الكدر
Chagrined = مكدّر
Chagrining = التكدير
Chagrins = الأكدار
Chain = السلسلة
Chained = مقيّد
Chaining = التقييد
Chainless = بلا سلسلة
Chainlike = كما السلسلة
Chainprinter = طابعة السلسلة
Chains = السلاسل
Chainsmoker = المدخّن الشّره
Chair = الكرسي
Chaired = مترأّس
Chairing = الترأّس
Chairman = الرئيس
Chairmanship = الرئاسة
Chairmanships = الرئاسة
Chairmen = الرؤساء
Chairperson = الرئيس
Chairpersons = الرؤساء
Chairs = الكراسي
Chairwoman = الرئيسة
Chairwomen = الرئيسات
Chaise = تشيس
Chalcedony = العقيق الأبيض
Chalcocite = شالكوسيت - معدن رماديّ ثقيل  (خامة نحاس)
Chalet = الشاليه
Chalice = الكأس
Chaliced = بشكل الفنجان
Chalices = الكؤوس
Chalk = الطباشير
Chalkboard = السّبّورة
Chalkcutter = الرّجل الذي يحفر الطّباشير
Chalked = خطّ
Chalkier = طباشيري
Chalkiest = طباشيري
Chalking = الخطّ
Chalkline = خطّ التّحديد
Chalkpit = المحجر للطّباشير
Chalks = الطّباشير
Chalky = طباشيري
Challenge = التحدي
Challengeable = قابل للتحدّي
Challenged = متحدّى
Challenger = المتحدي
Challengers = المتحدون
Challenges = التحديات
Challenging = التحدّي
Challengingly = بشكل صعب
Chalmers = تشالمرز
Chalybeate = حديديّ
Chamber = الغرفة
Chambered = يحتلّ هيئة تشريعيّة
Chamberer =  الذي يحضر الى الغرفة
Chamberers = الذين يحظرون الى الغرفة
Chambering = الفسوق
Chamberlain = تشامبرلن
Chamberlains = أمناء الخزانة
Chambermaid = عاملة التنظيف
Chambermaids = عاملات التنظيف
Chambers = الغرف
Chameleon = الحرباء
Chamfer = الشطب
Chamfered = مشطوب
Chamfering = الشطب
Chamfers = يشطب
Chamois = الشمواة
Chamoises = الشمواة
Chamomile = تشامومل
Champ = البطل
Champagne = الشمبانيا
Champagnes = الشمبانيا
Champaign = الشمبانيا
Champed = معضوض
Champers = الشّمبانيا
Champing = العضّ
Champion = البطل
Championed = دوفع عنه
Championing = الدفاع عن
Champions = الأبطال
Championship = البطولة
Championships = البطولات
Champlain = تشامبلين - مستكشف فرنسيّ في نوفا سكوتيا
Champs = الأبطال
Chance = الفرصة
Chanced = مصادف
Chancel = مذبح الكنيسة
Chancelleries = المستشاريات
Chancellery = المستشارية
Chancellor = المستشار
Chancellors = المستشارون
Chancellorship = المستشارية
Chancellorsville = تشانسيلورسفيل
Chancels = مذبح الكنيسة
Chanceries = المجالس
Chancery = المجلس
Chances = الفرص
Chancier = مشكوك
Chanciest = مشكوك
Chanciness = المخاطرة
Chancing = المصادفة
Chancre = تشانكر
Chancy = مشكوك
Chandelier = الثريا
Chandeliers = الثريات
Chandler = الشماع
Chang = تشانج
Change = التغيير
Change-over = التغيير
Changeability = التغير
Changeable = متغير
Changeableness = التّقلّب
Changeably = بتقلب
Changed = متغيّر
Changeful = متقلب
Changefulness = ممتلئ بالتّغيير
Changeless = ثابت
Changeling = استبدل
ChangeLog = سجل التغيير
Changeover = التغيير الكلّي
Changeovers = التغيير الكلّي
Changer = الصراف
Changers = الصرافون
Changes = التغييرات
Changing = التغيير
Channa = شانا
Channel = القناة
Channeled = محوّل
Channeling = التحويل
Channelled = وجّه
Channelling = التوجيه
ChannelNick = قناةاسم مستعار
Channels = القنوات
ChannelView = عرض القناة
Channing = تشانينج
Chanson = تشانسون
Chansons = الأغاني
Chant = الأنشودة
Chanted = هتف
Chanter = المرتّل
Chantey = تشانتي
Chanticleer = الدّيك
Chanticleers = الدّيوك
Chanting = الهتاف
Chantries = الكنائس الخاصّة
Chantry = الكنيسة الخاصّة
Chants = الأناشيد
Chao = تشاو
Chaos = الفوضى
Chaotic = فوضوي
Chaotically = باضطراب
Chap = الشاب
Chaparral = أرض البلّوط
Chapel = المصلى
Chapels = المصليات
Chaperon = الوصيفة
Chaperonage = الحماية
Chaperone = الوصيفة
Chaperoned = مرافق
Chaperones = الوصيفات
Chaperoning = المرافقة
Chaplain = القسيس
Chaplaincies = مدد عمل القسّيس
Chaplaincy = الكنيسة
Chaplains = القسسة
Chaplet = الإكليل
Chaplets = الأكاليل
Chaplin = شابلن - ممثّل كوميديّ و منتج أفلام إنجليزي
Chapman = التّاجر
Chapped = مشقوق
Chapping = الشقّ
Chaps = الشبّان
Chapter = الفصل
Chapters = الفصول
Char = الفحم
Character = الشخص
Character-oriented = موجه شخص
Charactered = للتّمييز بالماركات الخاصّة أو السّمات
Characteristic = الخاصية
Characteristically = على نحو مميز
Characteristics = الخصائص
Characterization = التمثيل
Characterizations = التمثيل
Characterize = ميّز
Characterized = مميّز
Characterizer = المميّز
Characterizers = المميّزون
Characterizes = يميّز
Characterizing = التمييز
Characters = الأشخاص
Charades = الحزورات
Charcoal = الفحم
Charcoals = الفحم
Chard = الشوندرة
Charge = الأجرة
Charge-coupled = مزاوج أجرة
Chargeable = قابل للإتهام
Chargeableness = يمكن المحاسبة عليه
Charged = مشحون
Charger = الشاحن
Chargers = الشاحنات
Charges = الأجور
Charging = الشحن
Chargings = الشحن
Charily = بحذر
Chariot = العربة
Charioteer = قائد العجلة الحربية
Chariots = العربات
Charisma = الهيبة
Charismas = الهيبة
Charismatic = مؤثّر
Charitable = خيري
Charitableness = الإحسان
Charitably = باحسان
Charities = المنظمات الخيرية
Charity = الصدقة
Charlatan = نصّاب
Charlatanism = الدّجل
Charlatanry = الدّجل, الإقناع
Charlatans = النصابون
Charlemagne = شارلمان
Charles = تشارلز
Charleston = تشارليستون
Charley = تشارلي
Charlie = تشارلي
Charlotte = شارلوت
Charlottesville = تشارلوتيسفيل
Charm = السحر
Charmed = مسحور
Charmer = الساحر
Charmers = السحرة
Charming = السحر
Charmingly = بشكل مسحور
Charmingness = سرور العقل أو الحواسّ في درجة عالية
Charmless = كئيب
Charms = السحر
Charon = شارون
