Conglomeration = التكتل
Conglomerations = التكتلات
Congo = الكونغو
Congolese = الكونغوليون
Congratulate = هنّئ
Congratulated = مهنّأ
Congratulates = يهنّئ
Congratulating = التهنئة
Congratulation = التهنأة
Congratulations = التهاني
Congratulator = المهنيء
Congratulatory = تهنيئي
Congregate = تجمّعي
Congregated = متجمّع
Congregates = يتجمّع
Congregating = التجمّع
Congregation = التجمع
Congregational = تجمّعي
Congregationalism = نظام كنسي
Congregationalist = جماعاتي
Congregationalists = الأبرشي
Congregations = التجمعات
Congress = الكونجرس
Congresses = المؤتمرات
Congressional = الكونجرس
Congressionally = عن الكونجرس
Congressman = عضو الكونجرس
Congressmen = أعضاء الكونجرس
Congresswoman = عضوة الكونجرس
Congresswomen = عضوات الكونجرس
Congruence = التطابق
Congruencies = التطابق
Congruency = التطابق
Congruent = متطابق
Congruently = بشكل متطابق
Congruities = الإتفاقيات
Congruity = الإتفاق
Congruous = مطابق
Congruously = بشكل مطابق
Congruousness = اﻷتفاق
Conic = مخروطي
Conical = مخروطي
Conically = بشكل مخروطي
Conicalness = المخروطيّة
Conics = هندسة المخروطيات
Conifer = الصنوبرية
Coniferous = صنوبري
Conifers = الصنوبريات
Conjecturable = مخمن
Conjectural = تخميني
Conjecturally = بشكل تخميني
Conjecture = التخمين
Conjectured = محدوس
Conjecturer = المخمن
Conjectures = التخمين
Conjecturing = الحدس
Conjoin = وحّد
Conjoined = موحّد
Conjoining = التوحيد
Conjoins = يوحّد
Conjoint = مربوط
Conjointly = بشكل مربوط
Conjugal = زوجي
Conjugally = بشكل زوجي
Conjugate = صرفي
Conjugated = مصرّف
Conjugately = بشكل صرفي
Conjugates = يصرّف
Conjugating = التصريف
Conjugation = الإقتران
Conjugations = الإقتران
Conjunct = إقتراني
Conjunction = الإرتباط
Conjunctions = الإرتباطات
Conjunctiva = الملتحمة
Conjunctive = حرف العطف
Conjunctively = بشكل رابط
Conjunctives = حرف العطف
Conjunctivitis = الرمد
Conjuncts = حروف العطف
Conjuncture = الأزمة
Conjunctures = الأزمات
Conjuration = تحضير الأرواح
Conjurations = التّعاويذ
Conjure = ناشد
Conjured = مناشد
Conjurer = المشعوذ
Conjurers = المشعوذون
Conjures = يناشد
Conjuring = الشعوذة
Conjuror = المشعوذ
Conk = الأنف
Conked = متعطّل
Conker = الكونكر (ثمر لا يؤكل)
Conking = التعطيل
Conks = الأنوف
Conley = مدينة كونلي
Conn = كون
Connate = خلقيّ
Connatural = خلقيّ
Connect = أوصل
Connectable = قابل للربط
Connected = مرتبط
Connectedly = بارتباط
Connectedness = التّرابط
Connecter = الموصّل
Connecters = الموصّلات
Connecticut = كونيكتيكت
Connecting = الإيصال
Connection = الإتّصال
Connections = الإرتباطات
Connective = رابط
Connectively = برابطة
Connectives = حروف العطف
Connectivity = الربط
Connector = الموصّل
Connectors = الموصّلات
Connects = يوصل
Conned = مخدوع
Connelly = كونيلي
Conner = كونير
Connie = كوني
Conning = الخدع
Conniption = نوبة الهستيرية
Connivance = التغاضي
Connive = تآمر
Connived = متآمر
Conniver = المتستّر
Connives = يتآمر
Conniving = التآمر
Connoisseur = ذوّاق
Connoisseurs = الخبراء
Connoisseurship = الخبرة، التذوق
Connors = كونورس
Connotation = التضمين
Connotations = التضمين
Connotative = تلميحي
Connotatively = بشكل تلميحي
Connote = إعن
Connoted = معني
Connotes = يعني
Connoting = العناية
Conns = كونس
Connubial = زيجي
Connubiality = الزوجيّة
Connubially = بشكل زيجي
Conquer = إفتح
Conquerable = مقهور
Conquered = محتل
Conquering = الفتح
Conqueringly = باخضاع
Conqueror = الفاتح
Conquerors = الفاتحون
Conquers = يفتح
Conquest = الغزو
Conquests = الفتوحات
Conquistador = الفاتح
Conquistadores = الفاتحون
Conquistadors = الفاتحون
Conrad = كونراد
Cons = يخدع
Consanguine = قريب
Consanguineous = قريب
Consanguineously = بشكل قريب
Consanguinity = قرابة الرحم
Conscience = الضمير
Consciences = الضمائر
Conscientious = واعي
Conscientiously = بشكل واعي
Conscientiousness = الوعي
Conscionable = مقبول
Conscious = الضمير
Consciouses = الضمائر
Consciously = شعوريا
Consciousness = الوعي
Conscript = المجنّد
Conscripted = مجنّد
Conscripting = التجنيد
Conscription = التجنيد
Conscriptions = التجنيد
Conscripts = المجنّدون
Consecrate = مكرّس
Consecrated = مكرّس
Consecrates = يكرّس
Consecrating = التكريس
Consecration = التكريس
Consecrations = التكريس
Consecutive = متتالي
Consecutively = بالتوالي
Consecutiveness = التتالي
Consensual = متلازم
Consensually = بشكل متلازم
Consensus = الإجماع
Consensuses = الإجماع
Consent = الموافقة
Consented = مقبول
Consenter = الموافق
Consenters = الموافقون
Consentient = موافق
Consenting = القبول
Consentingly = بموافقة
Consents = القبول
Consequence = النتيجة
Consequences = النتائج
Consequent = تابع
Consequential = ناتج
Consequentially = لاحقا
Consequentialness = النتيجة
Consequently = ولذلك
Conservable = قابل للحفظ
Conservation = الحماية
Conservationist = المحافظ على البيئة
Conservationists = المحافظون على البيئة
Conservations = الحمايات
Conservatism = المحافظية
Conservative = المحافظ
Conservatively = بشكل محافظ
Conservativeness = الحفظ
Conservatives = المحافظون
Conservator = الواقي
Conservatories = المعاهد الموسيقية
Conservatory = المعهد الموسيقي
Conserve = إحفظ
Conserved = محفوظ
Conserver = الموفّر
Conserves = يحفظ
Conserving = الحفظ
Consider = إعتبر
Considerable = كبير
Considerably = إلى حدّ كبير
Considerate = مراعي لشعور الآخرين
Considerately = بتعقّل
Considerateness = المراعاة
Consideration = الإعتبار
Considerations = الإعتبارات
Considered = معتبر
Considerer = المفترض
Considering = الإعتبار
Considers = يعتبر
Consign = أودع
Consignable = قابل للإيداع
Consigned = مودع
Consignee = المرسل إليه
Consigning = الإيداع
Consignment = الشحنة
Consignments = الشحنات
Consignor = المرسل
Consigns = يودع
Consist = تضمّن
Consisted = متضمّن
Consistence = التناسق
Consistencies = الإتساق
Consistency = الإتساق
Consistent = ثابت
Consistently = بثبات
Consisting = التضمين
Consistories = المجالس
Consistory = المجلس
Consists = يتضمّن
Consolable = المعزى (مستقبل العزاء)
Consolation = التعزية
Consolations = التعازي
Console = لوحة المفاتيح
Consoled = مواسى
Consoler = المؤازر
Consolers = المؤازرون
Consoles = لوحات المفاتيح
Consolidate = إدعم
Consolidated = مدعوم
Consolidates = يدعم
Consolidating = الدعم
Consolidation = التعزيز
Consolidations = التعزيزات
Consoling = المواساة
Consolingly = بمواساة
Consonance = الإنسجام
Consonances = الإنسجام
Consonant = الحرف الساكن
Consonantal = صحيح
Consonantally = بشكل صحيح
Consonantly = بشكل ساكن
Consonants = الحروف الساكنة
Consort = القرين
Consorted = معاشر
Consortia = الإتحادات المالية
Consorting = المعاشرة
Consortium = الإئتلاف
Consorts = الأقران
Conspicuous = واضح
Conspicuously = بشكل واضح
Conspicuousness = الوضوح
Conspiracies = المؤامرات
Conspiracy = المؤامرة
Conspirator = المتآمر
Conspiratorial = تآمري
Conspiratorially = بشكل تآمري
Conspirators = المتآمرون
Conspire = تآمر
Conspired = متآمر
Conspirer = المتآمر
