Credulity = السذاجة
Credulous = ساذج
Credulously = بسذاجة
Credulousness = السّذاجة
Cree = كري (قبيلة هندية)
Creed = المذهب
Creedal = عقائدي
Creeds = المذاهب
Creek = الجدول
Creeks = الجداول
Creekside = مدينة كريكسايد
Creep = إزحف
Creeped = زحف
Creeper = الزاحف
Creepers = الزواحف
Creepier = مخيف
Creepiest = مخيف
Creepily = بصورة مرعبة
Creepiness = القشعريرة
Creeping = الزحف
Creeps = يزحف
Creepy = مخيف
Creighton = كريغتن
Cremate = إحرق
Cremated = محروق
Cremates = يحرق
Cremating = الحرق
Cremation = الحرق
Cremations = الحرق
Crematories = أماكن إحراق الجثث
Crematorium = مكان إحراق الجثث
Crematory = حرقي
Creole = كرييولي
Creon = كريون ( أساطير يونانيّة )
Creosote = الطلاء
Crepe = نسيج الكرنب
Crepes = نسيج الكرنب
Crept = زحف
Crescendo = تزايد الصوت
Crescent = الهلال
Crescents = الأهلّة
Cress = الرشاد
Cresses = الرشاد
Crest = القمة
Crested = متوّج
Crestfallen = مكتئب
Crestfallenly = بشكل مكتئب
Cresting = التتويج
Crests = القمم
Crestview = مدينة كريستفيو
Cretaceous = طباشيري
Cretaceously = طباشيريا
Cretan = كريتي
Crete = كريت
Cretin = المشوه
Cretinous = أحمق
Cretins = المشوهون
Crevasse = الأخدود
Crevasses = الأخاديد
Crevice = الشقّ
Crevices = الشقوق
Crew = الطاقم
Crewcut = قصة البحارة
Crewed = عمل على متن
Crewel = الغزل الصّوفيّ
Crewing = عمل على متن
Crewman = فرد من طاقم
Crewmen = أفراد الطاقم
Crews = الطواقم
Crib = السرير
Cribbage = الكريبج
Cribbed = محبوس
Cribbing = الحبس
Cribs = الأسرّة
Crick = التشنج
Cricked = متشنّج
Cricket = الكريكت
Cricketer = لاعب الكريكت
Cricketers = لاعب الكريكت
Cricketing = لعب الكريكيت
Crickets = الصراصير
Cricking = التشنّج
Cricks = التشنجات
Cried = بكى
Crier = منادي المدينة
Criers = منادو المدينة
Cries = النداءات
Crime = الجريمة
Crimea = كريمي- شبه جزيرة أوكرانيّة
Crimean = القرم
Crimes = الجرائم
Criminal = المجرم
Criminality = الجريمة
Criminally = إجراميا
Criminals = المجرمون
Criminological = متعلّق بعلم الجريمة
Criminologist = باحث في علم الجريمة
Criminologists = باحثون في علم الجريمة
Criminology = علم الإجرام
Crimp = إعقص
Crimped = معقوص
Crimper = المكشكش
Crimping = العقص
Crimps = يعقص
Crimpy = كرمبي
Crimson = قرمزي
Crimsoning = القرمزة
Cringe = تذلّل
Cringed = متذلّل
Cringer = المهرول
Cringes = يتذلّل
Cringing = التذلّل
Crinkle = التجعيد
Crinkled = مجعّد
Crinkles = يجعّد
Crinkliness = التّجعّد
Crinkling = التجعيد
Crinkly = مجعّد
Cripple = الكسيح
Crippled = مشلول
Crippler = أداة تستخدم في دباغة الجلود
Cripples = الكسحاء
Crippling = الشلّ
Crises = الأزمات
Crisis = الأزمة
Crisp = هشّ
Crispbread = البسكويت السّادة
Crisper = هشّ
Crispier = أكثر هشاشة
Crispiest = أكثر هشاشة
Crispin = الاسكافي
Crisply = بشكل هشّ
Crispness = الهشاشة
Crisps = يجعّد
Crispy = هشّ
Criss = كريسس
Crisscross = الشبكة
Crisscrossed = تقاطع
Crisscrosses = الشّبكات
Crisscrossing = التّقاطع
Criteria = المعايير
Criterion = المعيار
Criterions = المعايير
Critic = الناقد
Critical = حرج
Criticality = الانتقاد
Critically = بشكل حرج
Criticalness = الخطورة
Criticism = النقد
Criticisms = النقد
Criticizable = قابل للنقد
Criticize = إنتقد
Criticized = منتقد
Criticizes = ينتقد
Criticizing = الإنتقاد
Critics = النقّاد
Critique = النقد
Critiqued = نوقش
Critiques = يناقش
Critiquing = المناقشة
Critter = المخلوق
Critters = المخلوقات
Croak = النعيق
Croaked = ناعق
Croaker = النّاعب
Croakers = النّاعبون
Croaking = النعيق
Croaks = ينعق
Croaky = كرواكي
Croatia = كرواتيا
Croatian = الكرواتي
Crochet = الكروشيه
Crocheted = مشبّك
Crocheting = الحياكة
Crochets = الكروشيهات
Crock = قطعة الخزف
Crocked = مسخّم
Crocker = كروكير
Crockery = الآنية الفخارية
Crockett = كروكيت
Crocks = يسخّم
Crocodile = التمساح
Crocodiles = التماسيح
Crocodilian = التّمساحي
Crocus = الزعفران
Crocuses = الزعفران
Croft = كروفت
Crofter = المستأجر
Crofters = المستأجر
Croix = كروا
Cromwell = كرومويل
Crone = العجوز الشمطاء
Crones = العجائز الشمطاوات
Cronies = الأزلام
Crony = الصديق
Crook = المحتال
Crooked = أعوج
Crookedly = باعوجاج
Crookedness = الإنحناء
Crooking = الإمالة
Crooks = المحتالون
Croon = دندن
Crooned = مدندن
Crooner = المغني
Crooners = المغني
Crooning = الدندنة
Croons = يدندن
Crop = المحصول
Cropped = مقصوص
Cropper = المثمر
Croppers = المثمر
Cropping = القصّ
Crops = المحاصيل
Croquet = الكروكيه
Crosby = كروسبي
Cross = الصليب
Cross-Assembler = عبر المجمع
Cross-over = عبّر
Cross-reference = الإحالة
Cross-road = تقاطع الطرق
Cross-talk = عبر الكلام
Cross-validation = عبر التصديق
Crossable = قابل للعبور
Crossbar = العارضة
Crossbars = العارضات
Crossbill = القرزبيل
Crossbow = القوس
Crossbows = الأقواس
Crossbred = هجين
Crossbreed = هجّن
Crosscurrent = تّيّار غير سلس (مطبات)
Crosscurrents = تّيّارات غير سلسة (مطبات)
Crosscut = إقطع
Crosscuts = يقطع
Crosscutting = القطع
CrossDiagonal = قطري منقطع
Crossed = معبور
Crosser = أشدّ غضبا
Crosses = الصلبان
Crosshatch = ظلّل
Crosshatched = ظلّل
Crosshatches = يظلّل
Crosshatching = التّظليل
Crossing = العبور
Crossings = المعابر
Crosslink = وصلة
Crossly = بشكل متقاطع
Crossover = الانتقال
Crossovers = عمليات الانتقال
Crossproduct = الضربٌ التصالبيٌّ
Crossproducts = الضربٌ تصالبيٌّ
Crossroad = تقاطع الطرق
Crossroads = تقاطع الطرق
Crosstalk = الحديث المتبادل
Crosswalk = معبر المشاة
Crossway = الطّريق المتقاطع
Crossways = على هيئة صليب
Crosswise = على هيئة صليب
Crossword = الكلمات المتقاطعة
Crosswords = الكلمات المتقاطعة
Crosswort = نوع من النباتات
Crotch = المنشعب
Crotched = متفرّع
Crotches = المنشعب
Crotchet = النزوة
Crotchetiness = الغرابة
Crotchets = النزوة
Crotchety = أوهامي
Crouch = التخضع
Crouched = جاثم
Crouches = يجثم
Crouching = الجثم
Croup = الخانوق
Croupier = مدير مائدة القمار
Croutons = الخبز المحمّص
Crow = الغراب
Crowbait = الجيفة
Crowbar = المخل
Crowbars = المخل
Crowberry = كروبيري
Crowd = الحشد
Crowded = مزدحم
Crowdedness = الازدحام
Crowder = المجمهر
Crowding = الإحتشاد
Crowds = الحشود
Crowed = ناعق
Crowfoot = رجل الغراب
Crowfoots = أرجل الغراب
Crowing = النعيق
Crowley = مدينة كرولي
Crown = التاج
Crowned = متوّج
Crowner = المتوج
Crowning = التتويج
Crowns = التيجان
Crows = الغربان
Croydon = عربة
CRT = إنبوب أشعة القطب السالب (شاشة التلفزيون)
Crucial = حاسم
