Doctored = معالج
Doctoring = المعالجة
Doctors = الأطباء
Doctrinaire = العقائدي
Doctrinal = مذهبي
Doctrinally = بشكل مذهبي
Doctrine = المذهب
Doctrines = المذاهب
Document = الوثيقة
Documentable = قابل للتوثيق
Documental = وثائقي
Documentaries = الوثائقيات
Documentary = البرنامج الوثائقي
Documentation = التوثيق
Documentations = التوثيقات
Documented = موثّق
Documenter = الموثق
Documenters = الموثّقين
Documenting = التوثيق
Documents = الوثائق
DOD = وزارة الدفاع
Dodd = دود
Dodder = إرتعش
Doddered = مرتعش
Doddering = الإرتعاش
Dodders = يرتعش
Dodecagon = الثّنعشري الأضلاع
Dodecagonal = متعلق ب الثّنعشري الأضلاع
Dodecagons = الثّنعشري الأضلاع
Dodecahedra = الثّنعشري السطوح
Dodecahedral = متعلق ب ثّنعشري السطوح
Dodecahedron = الثّنعشري السطوح
Dodge = الخدعة
Dodged = مراوغ
Dodger = المراوغ
Dodgers = المراوغون
Dodges = الخدع
Dodging = المراوغة
Dodington = دودنجتون
Dodo = طائر الدودو
Dodson = دودسون
Doe = الظبية
Doer = الفاعل
Doers = الفاعلون
Does = يعمل
Doff = إخلع
Doffed = مخلوع
Doffing = الخلع
Doffs = يخلع
Dog = الكلب
Dogbane = شجرة سامة
Dogberry = توت
Doge = رئيس القضاة
Dogfight = النزاع
Dogfish = كلب البحر
Dogged = الإصرار
Doggedly = باصرار
Doggedness = العناد
Doggerel = الشعر الركيك
Doggie = الكلب
Doggies = الكلاب
Dogging = الإزعاج
Doggish = وضيع
Doggishness = الوضاعة
Doggone = مزعج
Doggoned = ملعون
Doggoning = يلعن
Doggy = الكلب
Doghouse = بيت الكلب
Dogleg = المنعطف
Dogma = العقيدة
Dogmas = العقائد
Dogmatic = دكتاتوريّ
Dogmatical = مذهبيّ
Dogmatically = بشكل دوغماتي
Dogmaticalness = المذهبية
Dogmatics = الدوغماتية
Dogmatism = الدوغماتية
Dogmatisms = الدوغماتية
Dogmatist = الدوغماتي
Dogs = الكلاب
Dogtooth = حلية بالكنيسة
Dogtrot = الهرولة
Dogwood = نوع من الأشجار
Doherty = دورتي
Doilies = المفارش
Doily = المفرش
Doing = العمل
Doings = الأعمال
Dolan = دولان
Dolce = بحلاوة
Doldrums = الكساد
Dole = دول
Doled = وزّع
Doleful = كئيب
Dolefully = بكئابة شديدة
Dolefulness = الكئآبة
Doles = الصدقات
Doling = التوزيع
Doll = الدمية
Dollar = الدولار
Dollars = الدولارات
Dollied = محمول على عربة
Dollies = الدمى
Dollop = الكمشة
Dolls = الدمى
Dolly = دولي
Dollying = الحمل على عربة
Dolomite = الدولوميت
Dolomites = الدولوميت
Dolomitic = متعلق ب الدولوميت
Dolor = دولور
Dolores = دلوريس
Dolorous = مؤلم
Dolorously = بشكل مؤلم
Dolorousness = الحزن
Dolors = الأحزان
Dolphin = الدولفين
Dolphins = الدلافين
Dolt = الأبله
Doltish = بليد
Doltishly = بشكل بليد
Doltishness = الغباء
Domain = المجال
Domain-specific = مجال معيّن
Domains = المجالات
Dome = القبة
Domed = مقبّب
Domenico = دومينيكو
Domes = القبب
Domesday = يوم القيامة
Domestic = محلي
Domestically = داخليا
Domesticate = دجّن
Domesticated = مدجّن
Domesticates = يدجّن
Domesticating = التدجين
Domestication = التدجين
Domesticity = الحياة العائلية
Domestics = الخدم
Domicile = المسكن
Domiciled = مسكون
Domiciles = المساكن
Domiciling = السكون
Dominance = الهيمنة
Dominant = مهيمن
Dominantly = بشكل مهيمن
Dominate = سيطر
Dominated = سيطر
Dominates = يسيطر
Dominating = السيطرة
Domination = الهيمنة
Dominations = الهيمنة
Dominative = مهيمن
Dominator = المسيطر
Domineer = إستبدّ به
Domineered = مستبدّ ب
Domineering = الإستبداد
Domineeringly = بشكل مستبد
Domineeringness = التحكّم
Domineers = يستبدّ به
Doming = غطى بقبة
Domingo = دومينجو
Dominic = دومينيك
Dominica = الدومنيكا
Dominican = الدومنيكي
Dominicans = الدومنيكيون
Dominick = دومينيك
Dominie = المعلم
Dominion = السيادة
Dominions = الملاك
Dominique = دومينيك
Domino = الدومنة
Don = دون
Donah = دوناه
Donahue = دوناهو
Donald = دونالد
Donaldson = دونالدسون
Donate = تبرّع
Donated = متبرّع
Donates = يتبرّع
Donating = التبرّع
Donation = التبرّع
Donations = التبرّعات
Donative = تبرّعي
Done = معمول
Dong = الدونغ
Donkey = الحمار
Donkeys = الحمير
Donna = دونا
Donned = مرتدى
Donnelly = دونيلي
Donner = دونير
Donning = الإرتداء
Donnish = دون تقريبا
Donnishly = بشكل أكاديميّ
Donnishness = الأكاديميةّ
Donnybrook = دونيبروك
Donor = المتبرع
Donors = المتبرعون
Donovan = دونوفان
Dons = السادة
Donuts = الكعك
Doodle = الرسم
Doodled = عابث
Doodler = الساخر
Doodles = الرسومات
Doodling = العبث
Doohickey = دوهيكي
Dooley = دولي
Doolittle = دووليتل
Doom = الموت
Doomed = منكوب
Dooming = الإدانة
Dooms = الهلاك
Doomsday = يوم الحساب
Door = الباب
Doorbell = الجرس
Doorbells = الأجراس
Doorkeeper = البواب
Doorkeepers = البوّابون
Doorknob = مقبض الباب
Doorknobs = مقابض الابواب
Doorman = البوّاب
Doormat = ممسحة الأرجل
Doormen = البوّابون
Doors = الأبواب
Doorstep = العتبة
Doorsteps = العتبات
Doorstop = حاجز الباب
Doorway = المدخل
Doorways = المداخل
Dopant = المقوّي
Dope = المخدر
Doped = مخدّر
Doper = المدمن
Dopers = المدمنون
Dopes = المخدرات
Dopey = غبي
Dopier = أكثر تخدير
Dopiest = الأكثر تخدير
Dopiness = البلادة
Doping = التخدير
Doppler = دوبلر
Dora = دورا
Dorado = دورادو
Dorcas = دوركاس
Dorchester = دورجيستسر
Doreen = دورين
Doria = دوريا
Doric = دوريسي
Doris = دوريس
Dork = الأحمق
Dorm = المسكن
Dormancy = الخمول
Dormant = خامل
Dormer = الشباك
Dormice = الزغبات
Dormitories = المساكن
Dormitory = المسكن
Dormouse = الزغبة
Dorms = المساكن
Dorothea = دوروثي
Dorothy = دوروثي
Dorsal = ظهري
Dorsally = ظهريا
Dorset = نوع من الخراف
Dortmund = دورتموند
DOS = دوس (نظام تشغيل من ميكروسوفت)
Dosage = الجرعة
Dosages = الجرعات
Dose = الجرعة
Dosed = مداوى
Doses = الجرع
Dosimeter = جهاز قياس الاشعاع
Dosimeters = أجهزة قياس الاشعاع
Dosimetry = الجرعة
Dosing = المداواة
Dossier = الملف
Dossiers = الملفات
Dostoevsky = دوستويفسكاي
Dot = النقطة
Dot-matrix = مصفوفة نقطة
Dot-scanning = مسح النقطة
Dotage = الخرف
Dotard = الخرفان
Dote = إخرف
Doted = خارف
Doter = بطيء الاستيعاب
Dotes = يخرف
Doting = الخرف
Dotingly = بشكل مخرفّ
Dots = النقاط
Dotted = منقّط
Dottiness = الجنون
Dotting = التنقيط
Dotty = منقّط
Double = الضعف
Double-acting = ثنائي الفعل
Double-length = ثنائي الطول
