Aggregateness = التّجمّعيّة
Aggregates = المجاميع
Aggregating = التّجمّع
Aggregation = التّجميع
Aggregations = التّجميع
Aggregative = إجمالي
Aggregatively = بشكل إجمالي
Aggressing = الإعتداء
Aggression = العنف
Aggressions = العنف
Aggressive = عدوانيّ
Aggressively = بعدوانيّة
Aggressiveness = العدوانيّة
Aggressor = المعتدٍ
Aggressors = المعتدونً
Aggrieve = حزّن
Aggrieved = مهموم
Aggrievedly = بظلم
Aggrieves = يحزن
Aggrieving = الإحزان
Aghast = مذهول
Agile = رشيق
Agilely = برشاقة
Agility = الرّشاقة
Aging = الكبر
Agio = العمولة
Agiotage = الصّرافة
Agitate = طالب
Agitated = طالب
Agitatedly = بارتعاش
Agitates = يطالب
Agitating = المطالبة
Agitation = الانفعال
Agitations = الثّورات
Agitative = أجيتاتيف
Agitator = المشاغب
Agitators = المشاغبون
Agleam = مضيء
Aglow = متوهّج
Agnes = أجنيس
Agnew = أجنو
Agnomen = إسم مستعار إضافي
Agnostic = الملحد
Agnosticism = الإيمان القائم على الشك :: الإنكار بوجود الله
Agnostics = الملحدون
Ago = منذ
Agog = متلهّف
Agone = رَحَلَ
Agonies = كُروب
Agonize = يناضل
Agonized = ناضل
Agonizer = مناضِل
Agonizers = مناضلون
Agonizes = يناضل
Agonizing = مُناضَلة
Agonizingly = بنِضال
Agony = الكَرْب
Agoraphobia = خوف من الأماكن المكشوفة
Agouti = الأغوطي
Agrarian = زراعيّ
Agree = اتّفق
Agreeable = مناسب
Agreeableness = القبول
Agreeably = بشكل لطيف
Agreed = اتّفق
Agreeing = الاتّفاق
Agreement = الاتّفاقيّة
Agreements = الاتّفاقيّات
Agreer = موافق
Agreers = موافقون
Agrees = يتّفق
Agri = أجري
Agribusiness = تجارة المحاصيل
Agribusinesses = تجارات المحاصيل
Agricola = أجريكولا
Agricultural = زراعيّ
Agriculturalists = المهندسون الزّراعيّون
Agriculturally = متعلّق بالزّراعة
Agriculture = الزّراعة
Agricultures = الزراعة
Agriculturist = المزارع
Agrimony = الغافث
Agronomists = المهندسون الزّراعيّون
Agronomy = علم الزّراعة
Aground = ملامس القاع
Ague = الحمّى
Agway = أجواي
Ah = آه
Aha = آها
Ahead = في المقدّمة
Ahed = عهد
Ahem = نحنحة
Ahmadabad = أحمدأباد
Ahmedabad = أحمد آباد
Ahoy = صيحة البحّارة
Aid = المعونة
Aida = عايدة
Aide = المساعد
Aided = ساعد
Aider = أيدر
Aides = المساعدون
Aiding = المساعدة
Aids = المساعدات
Aiken = أيكين
Ail = امرض
Ailanthus = الإيلنطس
Aile = أيل
Ailed = مرض
Aileen = أيلين
Aileron = المؤخّرة
Ailerons = المؤخّرات
Ailing = المرض
Ailment = المرض
Ailments = الأمراض
Ails = يمرض
Aim = الهدف
Aimed = وجّه
Aimer = الهدّاف
Aimers = الهدّافون
Aiming = التّوجيه
Aimless = بلا هدف
Aimlessly = عشوائيًّا
Aimlessness = التّشتّت
Aims = الأهداف
Ainu = فرد من الأيْنو، لغة الأيْنو، جماعة من النازحين إلى الأرخبيل الياباني
Ainus = أفراد من الأيْنو، جماعة من النازحين إلى الأرخبيل الياباني
Air = الهواء
Air-condition = مكيّف
Air-mail = البريد الجوّيّ
Air-pump = المضخّة
Air-sick = مصاب بدوار الجوّ
Airbag = المخدّة الهوائيّة
Airbags = أكياس الهواء
Airborne = صاعد في الهواء
Airbrush = البخّاخة
Airbrushed = رشّ
Airbrushes = البخّاخات
Aircraft = الطّائرة
Airdrome = المطار
Airdrop = أسقط جوّيًّا
Airdrops = يسقط جوّيًّا
Aired = تعرّض للهواء
Airedale = كلب الصّيد
Airer = جوّيّ، هيكل لتجفيف أو تهوئة الملابس
Airers = جوّيّون، هياكل لتجفيف أو تهوئة الملابس
Airfare = الثّمن
Airfield = المطار
Airfields = المطارات
Airflow = جريان الهواء
Airfoil = حامل الطّائرة
Airfoils = حملة الطّائرة
Airframe = هيكل الطائرة
Airframes = هياكل الطائرات
Airhead = الغبيّ
Airier = متجدّد الهواء
Airiest = المتجدّد الهواء
Airily = بعبث
Airiness = التّهوية
Airing = النّزهة
Airings = النّزهات
Airless = فاسد الهواء
Airlessly = بشكل خال من الهواء
Airlessness = الخواء
Airlift = نقل جوي
Airlifts = الجسرات الجوّيّة
Airline = شركة الطّيران
Airliner = الطّائرة
Airliners = الطّائرات
Airlines = شركات الطّيران
Airlock = غرفة الضّغط
Airlocks = غرف الهواء المضغوط
Airmail = البريد الجوّيّ
Airmails = البريد الجوّيّة
Airman = المساعد
Airmass = الكتلة الهوائيّة
Airmen = المساعدون
Airpark = مطار مدني
Airplane = الطّائرة
Airplanes = الطّائرات
Airplay = البثّ
Airport = المطار
Airports = المطارات
Airs = المظاهر
Airship = المنطاد
Airships = المناطيد
Airsick = مصاب بدوار الجوّ
Airsickness = دوار الجوّ
Airsicknesses = دوارات الجوّ
Airspace = المجال الجوّيّ
Airspeed = السّرعة
Airspeeds = السّرعات
Airstrip = المهبط
Airstrips = المهابط
Airtel = هاتف هوائي
Airtight = محكم السّدّ
Airtightness = إحكام الشّد
Airway = الحنجرة، ممرّ هوائي، خطّ جوّي
Airways = الحناجر، ممرّات هوائيّة، خطوط جوّيّة
Airworthiness = الصّلاحيّة
Airworthy = صالح للطّيران
Airy = متجدّد الهواء
Aisle = الممرّ
Aisles = الممرّات
Aitken = أيتكين
Ajar = مفتوح جزئيًّا
Ajax = إجاكس
Ake = أك
Akers = أكيرز
Akimbo = أكيمبو
Akin = مشابه
Akron = أكرون
Ala = علاء
Alabama = ألاباما
Alabaman = فرد من ألاباما
Alabamans = أفراد من ألاباما
Alabamian = فرد من ألاباما
Alabamians = فرد من ألاباما
Alabaster = المرمر
Alacritous = مُتلهّف
Alacritously = بِلَهْفَة
Alacrity = اللّهفة
Alai = ألاي
Alameda = ألاميدا
Alamo = ألامو
Alamos = ألاموس
Alan = آلان
Alarm = الفزع
Alarmclock = المنبّه
Alarmed = مذعور
Alarmer = المنبّه
Alarming = مفزع
Alarmingly = بشكل مقلق
Alarmism = التّنبيه
Alarmist = القلق
Alarms = إنذارات الخطر
Alas = للأسف
Alaska = آلاسكا
Alb = الرّداء
Alba = ألبا
Albacore = البكورة
Albania = ألبانيا
Albanian = الألبانيّ
Albanians = الألبانيّون
Albany = ألباني
Albatross = البطروس
Albeit = ولو
Alberich = ألبيريتش
Albert = ألبرت
Alberta = ألبيرتا
Alberto = ألبيرتو
Albrecht = ألبريتشت
Albright = أولبرايت
Album = الألبوم
Albumen = البياض
Albumin = الزّلال
Albuminous = زلالي
Albums = الألبومات
Albuquerque = ألبوكيركي
Alcestis = ألسيستيس
Alchemists = الكيميائيّون
Alchemy = الكيمياء القديمة
Alcibiades = ألسيبْيادزْ - جنرال سياسي من أثينا
Alcmena = ألكمينا
Alcoa = ألكو
Alcohol = الكحول
Alcoholic = المدمن
Alcoholically = للكحول
Alcoholics = المدمنون
Alcoholism = الإدمان
Alcoholisms = إدمان الخمور
Alcohols = الكحول
Alcott = ألكوت
Alcove = تجويف، قبّة
Alcoved = مجوَّف، مقبّب
Alcoves = التّجاويف، قبب
Aldebaran = الدبران
Aldehyde = الألديهيد
Alden = ألدين
Alder = الألدر
Alderman = عضو مجلس محلّيّ
Aldermen = أعضاء مجلس محلّيّ
Aldrich = ألدريتش
Aldrin = ألدرين
Ale = البيرة
Aleatory = حظّي
Alec = أليك
Aleck = الاستعراضيّ
Alecks = أليكس
Alee = نحو جانب سفينة
Alehouse = البار
Aleph = أليف
Aler = ألر
Alert = الإنذار
Alerted = حذّر
Alerter = مُتيقّظ
Alerters = متيقّظون
Alerting = التّحذير
Alertly = بانتباه
Alertness = اليقظة
Alertnesses = اليقظة
