Eeriness = يرينيس
Efface = إمسح
Effaceable = قابل للمسح
Effaced = ممسوح
Effacement = الطمس
Effacements = الطمس
Effacer = الماسح
Effaces = يمسح
Effacing = المسح
Effect = التأثير
Effected = منجز
Effecting = الإحداث
Effective = فعّال
Effectively = عمليا
Effectiveness = التأثير
Effectless = غير فعّال
Effector = المستجيب
Effectors = المستجيبات
Effects = التأثيرات
Effectual = فعّال
Effectuality = القدرة على التأثير
Effectually = بشكل فعّال
Effectualness = الفاعليّة
Effectuate = أثّر
Effectuated = مؤثّر
Effectuates = يؤثّر
Effectuating = التأثير
Effectuation = الإتّمام
Effeminacy = الخنوثة
Effeminate = متخنث
Effeminately = بشكل متخنث
Effeminateness = الخنوثة
Efferent = ناقل
Efferently = بشكل ناقل
Effervesce = فر
Effervesced = مفار
Effervescence = الإنفعال
Effervescent = منفعل
Effervescently = بشكل منفعل
Effervesces = يفور
Effervescing = الفوران
Effete = واهن
Effetely = بشكل واهن
Effeteness = الضّعف، العقم
Efficacies = الكفاءات
Efficacious = فعّال
Efficaciously = بشكل فعّال
Efficaciousness = الفعالية
Efficacy = الكفاءة
Efficiencies = الكفاءات
Efficiency = الكفاءة
Efficient = كفوء
Efficiently = بشكل كفوء
Effie = إفي
Effigies = الدمى
Effigy = الدمية
Effloresce = أزهر
Efflorescent = مزهر
Effluence = الدفق
Effluences = الدفقات
Effluent = متدفّق
Effluents = المخلّفات السّائلة
Effluvia = الروائح
Effluvium = الرائحة
Efflux = الدفق
Effluxion = التدفق
Effort = الجهد
Effortless = سهل
Effortlessly = بشكل سهل
Effortlessness = السهولة
Efforts = الجهود
Effulgently = بشكل ساطع
Effuse = أرق
Effused = مراق
Effuses = يريق
Effusing = الإراقة
Effusion = الإراقة
Effusions = الإراقة
Effusive = فياض
Effusively = بشكل فياض
Effusiveness = الفيض
Eft = الإفت (زاحف)
Eg = على سبيل المثال
EGA = محوّل الجرافيك المحسّن
Egad = التّعجّب الذي يعبّر عن الفرح أو المفاجأة
Egalitarian = عادل
Egalitarianism = مذهب المساواة
Egan = إجان
Egerton = إجيرتون
Egg = البيض
Eggbeater = مضرب البيض
Eggcup = كأس البيضة
Egged = يحرّض, يحرّك
Egger = المحرض أو مجمع البيض
Egghead = المثقّف
Eggheaded = مثقّف
Eggheadedness = الثقافة
Eggheads = المثقّفون
Egging = التحريض، الاصرار
Eggnog = شراب البيض
Eggnogs = مشروبات البيض
Eggplant = الباذنجان
Eggplants = الباذنجان
Eggs = البيض
Eggshell = قشر البيض
Eggshells = قشور البيض
Ego = الأنا
Egocentric = مغرور
Egocentricity = الأنانيّة
Egoism = الأنا
Egoisms = الأنا
Egoist = أناني
Egoists = الأنانيون
Egomaniacal = مزهوّ
Egos = الأنا
Egotism = الغرورية
Egotisms = الغرورية
Egotist = المغرور
Egotistic = مغرور
Egotistical = مغرور
Egotistically = بشكل مغرور
Egotists = المغرورون
Egregious = شنيع
Egregiously = بشكل فضيع
Egregiousness = الفضاعة
Egress = الخروج
Egresses = المخارج
Egression = المخرج
Egressions = المخارج
Egret = مالك الحزين، أبن الماء
Egrets = أبناء الماء
Egypt = مصر
Egyptian = المصري
Egyptians = المصريون
Eh = ايه
Ehrlich = إهرليتش
Eichmann = آيتشمان
Eider = نوع من البط
Eiderdown = ريش العيدر
Eiderdowns = ريش العيدر
Eidetic = تخيّلي
Eigenvalue = معامل التحول الخطي
Eigenvalues = معامل التحول الخطي (جمع)
Eight = ثمانية
Eight-channel = القناة ثمانية
Eighteen = ثمانية عشر
Eighteenth = ثامن عشر
Eighteenthly = بشكل ثامن عشر
Eightfold = ثمانيّ
Eighth = الثمن
Eighthes = الثمن
Eighthly = ثامنا
Eighths = الأثمان
Eighties = الثمانينات
Eightieth = ثمانون
Eights = الثمانيات
Eighty = ثمانون
Eighty-column = العمود ثمانون
Eile = آيل
Eileen = آيلين
Einstein = آينشتاين
Einsteinian = منسوب ل أينشتين
Einsteinium = الآينشتانيوم
Eire = آير
Eisenhower = آيزنهاور
Eisner = آيسنير
Either = أمّا
Either-way = بأي من الطّرق
Either...or = أمّا.. أو
Ejaculate = إقذف
Ejaculated = مقذوف
Ejaculates = يقذف
Ejaculating = القذف
Ejaculation = القذف
Ejaculations = القذف
Ejaculatory = قذفي
Eject = إقذف
Ejected = مقذوف
Ejecting = القذف
Ejection = الطرد
Ejective = طردي
Ejector = القاذف
Ejectors = القاذفات
Ejects = يقذف
Ekberg = إكبيرج
Eke = دبّر
Eked = دبّر
Ekes = يدبّر
Eking = التدبير
Ekstrom = إكستروم
Ektachrome = إكتاتشروم
El = ال
Elaborate = متقن
Elaborated = متوسّع
Elaborately = بشكل متقن
Elaborateness = الإسهاب
Elaborates = يتوسّع
Elaborating = التوسّع
Elaboration = الإسهاب
Elaborations = الإسهاب
Elaborative = مسهب
Elaborators = المسهبون
Elaine = إلين
Elan = الهمّة
Elapse = إنقض
Elapsed = منقضي
Elapses = ينقضي
Elapsing = الإنقضاء
Elastic = الشريط المطاطي
Elastical = مرن
Elastically = مطاطيا
Elasticities = المرونة
Elasticity = المطاطية
Elasticly = بشكل مطاطي
Elastics = الأشرطة المطاطية
Elastomer = إلاستومر (يشبه المطاط)
Elate = إنتش
Elated = مبتهج
Elatedly = بشكل مبتهج
Elatedness = الابتهاج
Elater = إلاتر
Elates = ينتشي
Elating = الإنتشاء
Elation = الإنتشاء
Elba = إلبا
Elbow = المرفق
Elbowed = مدفوع
Elbowing = الدفع
Elbowroom = المجال
Elbows = المرافق
Elder = الشيخ
Elderliness = الكهولة
Elderly = مسن
Elders = الشيوخ
Eldest = أكبر
Eldon = إلدون
Eleanor = إلينور
Eleazar = إليزار
Elect = منتخب
Elected = منتخب
Electing = الإنتخاب
Election = الإنتخاب
Electioneer = منظم الإنتخابات
Electioneered = مساند مرشح
Electioneering = مساندة مرشح
Electioneers = منظمو الإنتخابات
Elections = الإنتخابات
Elective = إنتخابي
Electively = إختياريا
Electiveness = الاختيارية
Electives = الموادّ الاختياريّة
Elector = الناخب
Electoral = إنتخابي
Electorally = إنتخابيا
Electorate = الناخبون
Electorates = الناخبون
Electors = الناخبون
Electra = إليكترا
Electress = المنتخبة
Electret = ذو قطبية كهربائية دائمة
Electric = كهربائي
Electrical = كهربائي
Electrically = بشكل كهربائي
Electricalness = الحالة الكهربائية
Electrician = الكهربائي
Electricians = الكهربائيون
Electricities = الكهرباء
Electricity = الكهرباء
Electrics = الكهرباء
Electrification = الكهربة
Electrifications = الكهربة
Electrified = مكهرب
Electrifies = يكهرب
Electrify = كهرب
Electrifying = التكهرب
Electrize = كهرب
Electro = كهرو
Electroanalysis = التّحليل الكهربائيّ
Electrocardiogram = رسم القلب
Electrocardiograms = رسوم القلب
Electrocardiograph = جهاز رسم القلب
Electrochemical = كهروكيمياوي
Electrocute = كهرب
Electrocuted = مكهرب
Electrocutes = يكهرب
Electrocuting = التكهرب
Electrocution = القتل بالصدمة الكهربائية
Electrocutions = القتل بالصدمة الكهربائية
Electrode = القطب الكهربائي
Electrodes = الأقطاب الكهربائية
Electrodynamic = كهروديناميكي
Electrodynamicly = بشكل كهروديناميكي
Electrodynamics = الديناميكا الكهربائية
Electroencephalogram = رسم المخّ
Electroencephalograms = رسوم المخّ
Electroencephalograph = جهاز رسم المخّ
Electroencephalography = رسم المخّ
Electrographic = إليكتروجرافيك
Electrolysis = التحليل الكهربائي
Electrolyte = المنحل بالكهرباء
