Emblazons = يمجّد
Emblem = الشعار
Emblematic = رمزي
Emblematical = رمزي
Emblematically = بشكل رمزي
Emblems = الشعارات
Embodied = مجسّد
Embodier = المجسّد
Embodies = يجسّد
Embodiment = التضمين
Embodiments = التضمين
Embody = جسّد
Embodying = التجسيد
Embolden = شجّع
Emboldened = مشجّع
Emboldening = التشجيع
Emboldens = يشجّع
Embolism = الجلطة
Embolisms = الجلطات
Embosom = إحضن
Embosomed = محضون
Embosoming = الحضن
Embosoms = يحضن
Emboss = إنقش
Embossed = منقوش
Embosser = المزخرف
Embossers = المزخرفون
Embosses = ينقش
Embossing = النقش
Embossment = النقش
Embossments = النقوش
Embouchure = استخدام الشفاه، اللّسان و الأسنان في عزف آلات النفخ الموسيقية
Embower = ظلّل
Embrace = العناق
Embraceable = قابل للضّم
Embraced = تعانق
Embracement = العناق
Embracer = المعانق
Embraces = المعانقة
Embracing = التعانق
Embracingly = بعناق
Embracive = إحتوائي
Embrittle = هشّش
Embroider = طرّز
Embroidered = مطّرز
Embroiderer = المطّرز
Embroiderers = المطّرزون
Embroideries = التطريزات
Embroidering = التطريز
Embroiders = يطرّز
Embroidery = التطريز
Embroil = ورّط
Embroiled = مورّط
Embroiling = التوريط
Embroils = يورّط
Embryo = الجنين
Embryologic = جنيني
Embryological = جنيني
Embryologically = بشكل جنيني
Embryology = علم الأجنة
Embryonic = جنيني
Embryonically = بشكل جنيني
Embryos = الجنين
Emcee = المقدّم
Emceed = قدَم
Emend = صحّح
Emendable = قابل للتّصحيح
Emended = مصحّح
Emender = المصحح
Emerald = الزمردة
Emeralds = الزمردات
Emerge = إظهر
Emerged = ظاهر
Emergence = الظهور
Emergences = الظهور
Emergencies = حالات الطوارئ
Emergency = الطوارئ
Emergent = ظاهر
Emerges = يظهر
Emerging = الظهور
Emeries = الأحجار
Emeriti = المحارب الذي أنهى خدمته بشرف
Emeritus = فخري
Emersion = الطلوع
Emerson = إيمرسن
Emery = الحجر
Emetic = مقيئ
Emetics = المقيئات
Emigrant = مهاجر
Emigrants = المهاجرون
Emigrate = هاجر
Emigrated = مهاجر
Emigrates = يهاجر
Emigrating = الهجرة
Emigration = الهجرة
Emigrations = الهجرات
Emil = أميل
Emile = أميل
Emilio = إمليو
Emily = إيميلي
Eminence = السّموّ
Eminent = سامي
Eminently = بتفوق
Emirate = الإمارة
Emirates = الإمارات
Emissaries = المبعوثون
Emissary = المبعوث
Emission = الإشعاع
Emissions = الإشعاعات
Emissivities = قوة الإشعاع
Emissivity = قوة الإشعاع
Emit = إبعث
Emits = يبعث
Emittance = الابتعاثية
Emitted = مبعوث
Emitter = الباعث
Emitters = الباعثون
Emitting = البعث
Emma = إيما
Emmanuel = إمانويل
Emmett = إميت
Emolument = المكافأة
Emoluments = المكافآت
Emory = إموري
Emotion = العاطفة
Emotional = عاطفي
Emotionalism = العاطفية
Emotionality = العاطفية
Emotionally = عاطفيا
Emotionless = قاس
Emotions = العواطف
Empath = إمباث
Empathetically = بشكل تقمّصيّ
Empathic = تقمّصيّ
Empathized = تعاطف
Empathy = التعاطف
Emperor = الإمبراطور
Emperors = الأباطرة
Emphases = التأكيدات
Emphasis = التأكيد
Emphasize = أكّد
Emphasized = مؤكّد
Emphasizes = يؤكّد
Emphasizing = التأكيد
Emphatic = توكيدي
Emphatically = بتأكيد
Emphysema = الانتفاخ
Emphysematous = الامتلاء
Empire = الإمبراطورية
Empires = الإمبراطوريات
Empiric = المجرب
Empirical = تجريبي
Empirically = بشكل تجريبي
Empiricism = التجريبية
Empiricist = التجريبي
Empiricists = التجريبيون
Emplace = ضع
Emplacement = الموضع
Emplastic = إمبلاستيك
Employ = الإستخدام
Employability = الإستخدامية
Employable = قابل للإستخدام
Employed = مستخدم
Employee = المستخدم
Employees = المستخدمون
Employer = ربّ العمل
Employers = أرباب الأعمال
Employing = الإستخدام
Employment = التوظيف
Employments = التوظيف
Employs = الإستخدامات
Emporia = المخازن التجارية
Emporium = المتجر
Emporiums = المتاجر
Empower = شجّع
Empowered = مخوّل
Empowering = التشجيع
Empowers = يشجّع
Empress = الإمبراطورة
Empresses = الإمبراطورات
Emptied = مفرغ
Emptier = أفرغ
Empties = يفرغ
Emptiest = أفرغ
Emptily = بلا معنى
Emptiness = الفراغ
Empty = فارغ
Emptying = الإفراغ
Empyreal = السماء
Empyrean = السماء
Emulate = حاك
Emulated = محاكى
Emulates = يحاكي
Emulating = المحاكاة
Emulation = المحاكاة
Emulations = المحاكاة
Emulative = محاكي
Emulatively = بشكل محاكي
Emulator = المحاكي
Emulators = المحاكون
Emulsification = المستحلب
Emulsified = مستحلب
Emulsifier = المستحلب
Emulsifies = يستحلب
Emulsify = إستحلب
Emulsifying = الإستحلاب
Emulsion = المستحلب
Emulsions = المستحلبات
Emulsive = مستحلب
En = إن
Enable = يؤهّل‎، يخول، يمكن
EnableColorCorrection = تمكين تصحيح الألوان
Enabled = ممكّن
Enabler = المساعد
Enablers = المساعدون
Enables = يمكّن
Enabling = التمكين
Enact = شرّع
Enacted = مشرّع
Enacting = التشريع
Enactment = التشريع
Enactments = التشريعات
Enacts = يشرّع
Enamel = المينا
Enameled = مصقول
Enameler = الصاقل (يصقل)
Enamelers = الصقَال (يصقل)
Enameling = الصَقل
Enamelled = مطلي
Enamelling = الطلي
Enamels = يطلي
Enamor = إفتن
Enamored = مفتون
Enamoring = الفتنة
Enamors = يفتن
Enamour = إفتن
Enamoured = معجب
Enamours = فتن
Encamp = عسكر
Encamped = معسكر
Encamping = العسكرة
Encampment = المعسكر
Encampments = المعسكرات
Encamps = يعسكر
Encapsulate = غلّف
Encapsulated = مغلّف
Encapsulates = يغلّف
Encapsulating = التغليف
Encapsulation = التّلخيص
Encapsulations = التّلخيصات
Encase = غلّف
Encased = مغلّف
Encasement = التغليف
Encasements = التغليفات
Encases = يغلّف
Encasing = التغليف
Encephalitis = إلتهاب الدماغ
Encephalographic = متعلق برسم الدّماغ
Encephalopathy = التّلف الدّماغيّ
Enchain = قيّد
Enchained = مقيّد
Enchaining = التقييد
Enchains = يقيّد
Enchant = إسحر
Enchanted = مسحور
Enchanter = الساحر
Enchanters = السحرة
Enchanting = السحر
Enchantingly = بشكل بهيج
Enchantment = السحر
Enchantments = السحر
Enchantress = الساحرة
Enchantresses = الساحرات
Enchants = يسحر
Encharge = تكلفة :: يضع قيمة او ثمن :: يفرض قيمة او ثمن
Enchase = رصّع
Enchiladas = الإنتشلادا
Encipher = شفّر
Enciphered = مشفّر
Encipherer = المشفّر
Enciphering = التشفير
Enciphers = يشفّر
Encircle = طوّق
Encircled = مطوّق
Encirclement = التطويق
Encirclements = التطويق
Encircles = يطوّق
Encircling = التطويق
Enclave = الجيب
Enclaves = الجيوب
Enclose = أرفق
Enclosed = مرفق
Encloses = يرفق
Enclosing = الإرفاق
Enclosure = التسييج
Enclosures = المرفقات
Encode = شفّر
Encoded = مشفّر
Encoder = آلة التّشفير
Encoders = آلات التّشفير
