Flavoring = النكهة
Flavorings = النكهات
Flavorless = بلا طعم
Flavors = النكهات
Flavour = النكهة
Flavoured = منكّه
Flavourless = سيء الطعم
Flavours = النكهات
Flaw = العيب
Flawed = خاطئ
Flawing = الكسر
Flawless = لا عيب فيه
Flawlessly = دون عيب
Flawlessness = السلامة
Flaws = العيوب
Flawy = معيوب
Flax = الكتان
Flaxen = كتّاني
Flaxseed = حبْ الكتّان
Flaxy = كتاني
Flay = إسلخ
Flayed = مسلوخ
Flaying = السلخ
Flays = يسلخ
Flea = البرغوث
Fleabane = فلي بين
Fleam = المشرط
Fleams = المشارط
Fleas = البراغيث
Fleawort = فلي وورت (عشب طبّي)
Fleck = البقعة
Flecked = منقّط
Flecker = يبقّع
Fleckered = مبقّع
Fleckers = البقع
Flecking = التنقيط
Fleckless = نظيف
Flecks = البقع
Flection = الثّني
Flectional = إنثنائي
Flections = إنثناءات
Fled = هرب
Fledge = ريّش
Fledged = مريّش
Fledgeless = بلا ريش
Fledgeling = الفرخ
Fledgelings = الفراخ
Fledges = يريّش
Fledging = الترييش
Fledgling = الفرخ
Fledglings = الفراخ
Flee = إهرب
Fleece = الصوف
Fleeced = مجزوز
Fleeces = الأصواف
Fleecier = ناعم
Fleeciest = ناعم
Fleecily = مغطى بالصوف
Fleecing = الجزّ
Fleecy = ناعم
Fleed = فليد
Fleeing = الهروب
Fleer = السخرية
Flees = يهرب
Fleet = الأسطول
Fleetest = سريع
Fleeting = الإنطلاق
Fleetingly = زائلا
Fleetingness = البقاء القصير
Fleetly = بشكل سريع
Fleetness = السرعة
Fleets = الأساطيل
Fleischman = فليشمان
Fleisher = فليشر
Fleming = الفلاندري
Flemings = الفلمنجيون
Flemish = فلمنكي
Flesh = اللحم
Fleshed = سمين
Flesher = الجزار
Fleshes = اللحوم
Fleshier = سمين
Fleshiest = سمين
Fleshiness = السمنة
Fleshing = التغذية باللحم
Fleshings = بنطلونات بلون اللحم
Fleshless = هزيل
Fleshlier = جسدي
Fleshliest = جسدي
Fleshling = الحسّيّ
Fleshly = جسدي
Fleshy = سمين
Fletch = جهّز بريش
Fletched = مجهّز بريش
Fletcher = صانع السهام
Fletches = يجهّز بريش
Fletching = الرّيش على السهم
Fletchings = الرّيش على السهم
Flew = طار
Flews = الشّفة العليا
Flex = العطف
Flexed = مثني
Flexes = العطف
Flexibilities = المرونة
Flexibility = المرونة
Flexible = مرن
Flexibleness = المرونة
Flexibly = بمرونة
Flexile = مرن
Flexilely = بشكل مرن
Flexing = الثناء
Flexion = الإنحناء
Flexional = مرن
Flexions = الإنحناءات
Flexor = العضلة القابضة
Flexors = العضلات القابضة
Flextime = أوقات العمل المرنة
Flexuose = متعرّج
Flexuosity = التّعرّج
Flexuous = مرن
Flexural = تعرّجي
Flexure = الانثناء
Flick = النقرة
Flicked = حرّك
Flicker = الرجفة
Flickered = مومض
Flickering = الإيماض
Flickeringly = بصورة مضطربة
Flickers = الرجفات
Flicking = التحريك
Flicks = النقر
Flier = الطيّار
Fliers = الطيّارون
Flies = الذباب
Flight = الطيران
Flightier = أكثر طيشا
Flightiest = أكثر طيشا
Flightiness = التقلّب
Flightless = لا يطير
Flightlessly = بشكل لا يطير
Flights = الرحلات
Flighty = طائش
Flimsier = أضعف
Flimsies = رقيق
Flimsiest = أضعف
Flimsiness = الضعف
Flimsy = ضعيف
Flinch = الجفلة
Flinched = جافل
Flincher = المنتفض
Flinches = الجفلات
Flinching = الجفل
Flinchingly = باجفال
Fling = العلاقة المؤقّتة
Flinger = السّاخر
Flinging = الرمي
Flings = العلاقات مؤقّتة
Flint = الصوان
Flintier = متصلّب
Flintiest = متصلّب
Flintiness = القسوة
Flintlock = زر أمان البندقية
Flintlocks = أزرار أمان البندقية
Flints = الصوان
Flinty = متصلّب
Flip = النقرة
Flip-flop = تقلّب
Flipflop = يرجع عن قرار
Flippancy = ذلاقة اللسان
Flippant = ثرثار
Flippantly = بشكل ثرثار
Flipped = مقلّب
Flipper = الزعنفة
Flippers = الزعانف
Flipping = التقليب
Flips = النقر
Flipside = الجانب الثاني
Flirt = اللعوب
Flirtation = المغازلة
Flirtations = المغازلة
Flirtatious = مغازل
Flirtatiously = بشكل مغازل
Flirtatiousness = الخلاعة
Flirted = متغازل
Flirter = فليرتر
Flirting = التغازل
Flirtingly = بمجاملة
Flirts = اللعوبون
Flit = رفرف
Flitch = لحم الخنزير المدخّن
Flitches = لحوم الخنازير المدخّنة
Flits = يرفرف
Flitted = مرفرف
Flittered = مصفّق
Flittering = التصفيق
Flitters = يصفّق
Flitting = الرفرفة
Flivver = سيارة قديمة
Flivvers = سيارات قديمة
Flo = سهم
Float = الطوف
Floatable = قابل للطفو
Floatage = الطّفو
Floatages = الطّفو
Floatation = التعويم
Floated = معام
Floater = العوّام
Floaters = العوّامات
Floating = العوم
Floating-point = النقطة العائمة
Floats = العربات
Floc = الشوائب
Flocci = صوف
Floccose = مخصّل
Flocculate = تلبّد
Flocculated = متلبّد
Flocculates = يتلبّد
Flocculating = التلبّد
Flocculation = الدّمج
Flocculent = صوفي
Floccus = خصلة
Flock = القطيع
Flocked = متجمّع
Flocking = التجمّع
Flocks = القطعان
Floe = الطوف الجليدي
Floes = الطفاوات الجليدية
Flog = إجلد
Flogged = مجلود
Flogging = الجلد
Floggings = الجلد
Flogs = يجلد
Flood = الفيضان
Flooded = مصاب بالفيضان
Flooder = فلودر
Floodgate = البوابة
Floodgates = البوابات
Flooding = الفيضان
Floodings = الفيضانات
Floodlight = الضوء الكاشف
Floodlights = الأضواء الكاشفة
Floodlit = أضاء
Floods = الفيضانات
Floodwater = مياه الفيضان
Floodwaters = مياه الفيضانات
Floor = الأرضية
Floorboard = لوح الأرضية
Floorboards = ألواح الأرضية
Floored = بلّط
Floorer = في الطابق
Flooring = الأرضية
Floorings = الأرضيات
Floorless = بلا أرضية
Floors = الطوابق
Floorwalker = المراقب
Floorwalkers = المراقبون
Floozie = بائعة الهوى
Floozies = بائعات الهوى
Floozy = بائعة الهوى
Flop = الفشل
Flophouse = فندق رديء
Flophouses = فنادق رديئة
Flopped = متخبّط
Floppier = أكثر مرونة
Floppies = فلوبيس
Floppiest = أكثر مرونة
Floppily = بشكل مرن
Floppiness = الخيبة
Flopping = التخبّط
Floppy = مرن
Floppy-disk = القرص المرن
Flops = يتخبّط
Flora = الحياة النّباتيّة
Floral = زهري
Florally = بشكل زهري
Floras = النباتات
Florence = فلورينس
Florentine = فلورنسي (إيطاليا)
Florescence = التنوير
Florescences = التنوير
Floret = الزّهرة الصّغيرة
Florets = الزّهور الصّغيرة
Florican = دجاجة بر هنديّة
Floriculture = تنبيت الأزهار
Floricultures = تنبيت الأزهار
Florid = معقّد
Florida = فلوريدا
Floridian = مواطن فلوريدا
Floridians = مواطنو فلوريدا
Floridity = التورّد
Floridly = بشكل معقّد
Floridness = التورّد
Florin = الفلورين
Florist = بائع الزهور
Florists = باعة الزهور
Floss = الخيط
Flossed = نظّف
Flosses = الخيوط
Flossier = خيطي
Flossiest = خيطي
