Hooper = هوبير
Hooping = التطويق
Hoopla = الهرج والمرج
Hooplas = الهرج والمرج
Hoopoe = الهدهد
Hoopoes = الهداهد
Hoops = الأطواق
Hooray = الصّيحة
Hoorays = الصّيحات
Hoosegow = السّجن
Hoosegows = السّجون
Hoosier = هوسير - مواطن ولاية إنديانا
Hoot = النعيب
Hooted = مصيح
Hootenannies = الغناء الشعبي
Hootenanny = الغناء الشعبي
Hooter = البوق
Hooters = الأبواق
Hooting = الصيحة
Hoots = العطعطة
Hoover = هوفير
Hooves = الحوافر
Hop = القفزة
Hope = الأمل
Hoped = متمنّى
Hopeful = متفائل
Hopefully = على أمل
Hopefulness = الأمل
Hopefuls = المتفائلون
Hopeless = يائس
Hopelessly = بشكل يائس
Hopelessness = اليأس
Hoper = المتمني
Hopes = الآمال
Hopi = هوبي - اللغة الشوشونية
Hoping = التمنّي
Hopkins = هوبكنز
Hopped = قافز
Hopper = النطاط
Hoppers = النطاطات
Hopping = القفز
Hopple = يربط
Hoppled = ربط، مربوط
Hopples = يربط
Hops = القفزات
Hopscotch = لعبة المربعات
Horace = هوراس
Horatio = هوراشيو
Horde = الحشد
Hordes = الحشود
Horehound = النّعناع
Horizon = الأفق
Horizons = الآفاق
Horizontal = أفقي
Horizontally = أفقيا
Hormonal = هورموني
Hormone = الهورمون
Hormones = الهورمونات
Horn = القرن
Hornbeam = شجرة النّير
Hornblende = الهورنبلند - معدن
Hornblower = نافخ البوق
Horned = مقرّن
Hornedness = متعلق بذوات القرون
Hornet = الدّبّور
Hornets = الزنابير
Hornier = أكثر تقرّنا
Horniest = أكثر تقرّنا
Horniness = القسوة
Horns = القرون
Horntail = الذبابة المنشاريّة
Hornwort = هورنوورت - نبات مائي
Horny = مقرّن
Horologe = السّاعة
Horology = علم قياس الزمن
Horoscope = الطالع
Horoscopes = الطوالع
Horowitz = هورويز
Horrendous = مفزع
Horrendously = بشكل مفزع
Horrible = فظيع
Horribleness = البذاءة
Horribly = بشكل مروّع
Horrid = مروّع
Horridly = ببشاعة
Horridness = البشاعة
Horrified = مذعور
Horrifies = يروّع
Horrify = روّع
Horrifying = الترويع
Horrifyingly = بشكل مرعب
Horror = الرعب
Horrors = الرعب
Horse = الحصان
Horseback = ظهور الخيل
Horsed = زوّد بجواد
Horseflesh = لحم الخيل
Horseflies = ذباب الخيل
Horsefly = ذبابة الخيل
Horsehair = السبّيب
Horsely = هورسيلي
Horseman = الخيال
Horsemanship = الفروسية
Horsemen = الخيالة
Horsens = هورسنز
Horseplay = الخشونة
Horseplayer = الفارس القاسي على الجواد
Horsepower = الحصان
Horseradish = الفجل
Horseradishes = الفجل
Horses = الخيول
Horseshoe = حذوة الحصان
Horseshoer = هورسيشوير
Horseshoes = حذوات الحصن
Horsetail = ذيل الحصان
Horsewhip = السوط
Horsewoman = الفارسة
Horsewomen = الفارسات
Horsing = التزويد بحصان
Hortative = تشجيعي
Hortatory = تشجيعي
Horticultural = بستاني
Horticulturally = بشكل بستاني
Horticulture = البستنة
Horticulturist = البستاني
Horton = هورتن
Horus = حورس - إله الشمس
Hose = الخرطوم
Hosed = مسقي
Hoses = الخراطيم
Hosiery = الجوارب
Hosing = السقاية
Hospice = دار العجزة
Hospices = دور العجزة
Hospitable = مضياف
Hospitableness = الضيافة
Hospitably = ضيافيا
Hospital = المستشفى
Hospitality = الكرم
Hospitalization = العلاج بالمستشفى
Hospitalizations = العلاج بالمستشفى
Hospitalize = أدخل المستشفى
Hospitalized = مدخل المستشفى
Hospitalizes = يدخل المستشفى
Hospitalizing = إدخال المستشفى
Hospitals = المستشفيات
Host = المضيّف
Hostage = الرهينة
Hostages = الرهائن
HostDomain = النطاقالمضيف
Hosted = مستضاف
Hostel = الفندق
Hostelries = الخانات
Hostelry = الخان
Hostels = الفنادق
Hostess = المضيّفة
Hostesses = المضيّفات
Hostile = معادي
Hostilely = بشكل معادي
Hostilities = العداوات
Hostility = العداوة
Hosting = الإستضافة
Hostler = السائس
Hostlers = السياس
Hostly = بترحيب
Hostname = اسم المضيّف
HOSTNAMEPORT = اسم المضيفالبوابة
Hosts = المضيّفون
HostUser = مستضيفمستخدم
Hot = حار
Hot-dipped = الحار المنخفض
Hotbed = المستنبت
Hotbox = محور السيارة عندما ترتفع حرارته
Hotdogs = المقانق المقلية
Hotel = الفندق
Hotelier = مدير الفندق
Hotelman = مدير الفندق
Hotels = الفنادق
Hotfoot = استعجل
Hothead = المتهور
Hotheaded = متهوّر
Hotheadedly = بتهوّر
Hotheadedness = التهوّر
Hotheads = المتهورون
Hothouse = المستدفأ الإستنباتي
Hotkey = المفتاح الذي يُبَرْمَج على أن يؤدّي سلسلةً من الخطوات
Hotlist = القائمة السريعة
Hotly = بشكل حار
Hotness = الحرارة
Hotrod = السّيّارة المعدّلة
Hotshot = العامل البارع
Hotspur = عنيف
Hottentot = أسمر
Hotter = أحرّ
Hottest = أحرّ
Houdaille = هوديل
Houdini = هودني
Hough = هوغ
Houghton = هوغتون
Hound = كلب الصيد
Hounded = مطارد
Hounder = الملاحِق
Hounding = المطاردة
Hounds = كلاب الصيد
Hour = الساعة
Hourglass = السّاعة الرّمليّة
Hourglasses = السّاعات الرّمليّة
Hourly = كل ساعة
Hourr = هور
Hours = الساعات
House = المنزل
Houseboat = المركب
Houseboats = المراكب
Housebreak = روّض
Housebreaker = اللّصّ
Housebreakers = اللّصّوص
Housebreaking = التّرويض
Housebreakings = سرقات المنازل
Housebroken = أليف
Housecoat = الرّوب
Housed = مسكن
Houseflies = الذّباب
Housefly = الذّبابة
Household = العائلة
Householder = المستأجر
Householders = المستأجرون
Households = العوائل
Housekeep = يدير المنزل
Housekeeper = مدبرة المنزل
Housekeepers = مدبرات المنزل
Housekeeping = التدبير المنزلي
Housemaid = الخادمة
Houser = المشرف على مشاريع الإسكان
Houses = البيوت
Housetop = سطح المنزل
Housetops = أسطح المنازل
Housewares = أدوات المطبخ
Housewife = ربّة البيت
Housewifeliness = متعلق بربّة البيت
Housewifely = متعلق بربّة البيت
Housewives = ربّات البيوت
Housework = الشغل المنزلي
Houseworker = الخادم
Houseworkers = الخدم
Housing = الإسكان
Housings = المقرّات
Houston = هيوستن
Hove = إنتفخ
Hovel = الكوخ
Hovels = الأكواخ
Hover = حم
Hovercraft = الحوامة
Hovered = حائم
Hoverer = المحلّق
Hovering = الحوم
Hovers = يحوم
How = كيف
Howard = هاوارد
Howbeit = مع ذلك
Howdy = مرحبًا
Howe = هو
Howell = هاويل
However = على أية حال
Howitzer = الهاون
Howl = العواء
Howled = معوي
Howler = الغلطة الفاحشة
Howling = العواء
Howls = يعوي
Hows = هاوس
Howsoever = مع ذلك
Hoy = السّفينة
Hoyden = الفتاة الصاخبة
Hoydenish = مستهتر
Hoyt = هويت
HP = شركه هولت باكرد
Hrothgar = هروثجار
Hrs = الساعات
Html = اللغة المستعملة في بناء وثائق النّصّ المتشعّب أو المتصفّحات وتسمى الويب
Http = بروتوكول انتقال النّصّ المتشعّب
Hub = المحور
Hubbard = هوبارد
Hubbell = هوبيل
Hubbies = الأزواج
Hubble = هبل
Hubbub = الضجيج
Hubby = الزوج
Hubcap = غطاء إطار السيارة
Huber = هوبير
Hubert = هيوبرت
Hubris = الكبرياء
Hubristic = إستعلائي
Hubs = المحاور
Huck = القطن الخشن أو قماش الكتّان
Huckleberries = التّوت
Huckleberry = التّوت
Huckster = البائع المتجول
Huckstered = مساوم
Huckstering = المساومة
Hucksters = الباعة المتجولون
