Hydro = المصحة المائية
Hydrocarbon = الهيدروكربون
Hydrocarbons = الهيدروكربون
Hydrocele = القيلة
Hydroceles = القيلات
Hydrocephalies = تضخّم الرأس
Hydrocephalus = تضخّم الرأس
Hydrocephaly = متعلق بتضخّم الرأس
Hydrochloric = حمض الهيدرو كلوريك
Hydrochloride = الهيدروكلوريد
Hydrodynamic = متعلّق بقوّة مائيّة
Hydrodynamics = الهيدروناميكا
Hydroelectric = كهرومائي
Hydrofluoric = متعلق بالهيدروفلورين
Hydrofoil = القارب المزعنف
Hydrofoils = القوارب المزعنفة
Hydrogen = الهيدروجين
Hydrogenate = هدرج
Hydrogenated = مهدرج
Hydrogenates = يهدرج
Hydrogenating = التهدرج
Hydrogenation = الهدرجة
Hydrogenous = هايدروجيني
Hydrogens = الهيدروجين
Hydrological = هيدرولوجيّ
Hydrologically = الهيدرولوجية
Hydrology = دراسة الموارد المائية
Hydrolysis = التميّؤ
Hydrolytic = متحلّل بالماء
Hydrolyzed = تحلّل
Hydrometer = مقياس ثقل السّائل النّوعيّ
Hydrometers = الهيدرومتر
Hydronium = هيدرونيوم
Hydropathic = متعلق بالعلاج بالماء
Hydropathies = العلاج بالماء
Hydropathy = العلاج بالماء
Hydrophilic = قابل للاتّحاد مع الماء
Hydrophobia = داء الكلب
Hydrophobic = مصاب بفوبيا الماء
Hydroplane = الزّلّاقة
Hydroplanes = الزّلّاقات
Hydros = المصحّات المائية
Hydrosphere = المحيط المائيّ
Hydrostatic = متوازن مائيًّا
Hydrostatics = أستاتيكا الموائع
Hydrothermal = خاصّ بالمياه الحارّة
Hydrothermally = خاصّ بالمياه الحارّة
Hydrous = مائيّ
Hydroxide = الهيدروكسيد
Hydroxides = الهيدروكسيد
Hydroxy = هيدروكسيلي
Hydroxyl = هيدروكسيل
Hydroxylate = يدخل عنصر الهيدروكسيل
Hydroxylation = يدخل عنصر الهيدروكسيل
Hydroxyls = الهيدروكسيل
Hydroxyzine = هيدروكسيزاين
Hydrus = هيدرس - نجوم
Hyena = الضبع
Hyenas = الضباع
Hygiene = النظافة
Hygienic = صحّي
Hygienically = صحيا
Hygienics = علم الصّحّة
Hygienist = المساعد الصّحي
Hygrometer = مقياس درجة الرطوبة
Hygrometers = مقياس درجة الرطوبة
Hygroscope = مقياس الرّطوبة
Hygroscopic = متعلق بمقياس الرّطوبة
Hygroscopical = متعلق بمقياس الرّطوبة
Hying = التعجيل
Hyman = هيمان
Hymen = غشاء البكارة
Hymens = أغشية البكارة
Hymn = الترتيلة
Hymnal = كتاب التراتيل
Hymnals = كتب التراتيل
Hymning = التسبيح
Hymnody = إنشاد التّراتيل
Hymns = التراتيل
Hype = الدعاية
Hyped = روّج له
Hyper = جدا
Hyperactive = شديد النشاط
Hyperbola = القطع الزائد
Hyperbolas = القطوع الزائدة
Hyperbole = المبالغة
Hyperbolic = إطنابي
Hyperbolical = إطنابي
Hyperbolically = بشكل إطنابي
Hyperboloid = متعلق بالقطع الزّائد
Hyperboloidal = متعلق بالقطع الزّائد
Hypercellularity = كثرة الخلايا بشكل غير طبيعي
Hypercritical = شديد الانتقاد
Hypercritically = بشكل شديد الانتقاد
Hypercube = مكعّب ذو بُعد رابع
Hypercubes = مكعّبات ذات بُعد رابع
Hyperemia = فرط الدّم
Hyperemic = متعلق بفرط الدّم
Hyperfine = شديد الدقّة
Hyperfunction = عملية كبيرة
Hyperfunctions = عمليات كبيرة
Hypergamy = الزواج من نفس الطبقة أو أعلى
Hyperlink = الوصلة الفائقة
Hyperopia = الإبصار للبعيد أفضل منه للقريب
Hyperplasia = التضخّم الكمّي
Hypersensitive = شديد الحساسية
Hypersensitivity = فرط الحساسية
Hypersonic = فائق سرعة الصّوت
Hypertension = إرتفاع ضغط الدم
Hypertensive = إرتفاع ضغط الدمّ
Hypertext = مادة الإنترنت
Hypertrophic = متعلق بتضخّم بعض أجزاء الجسم
Hypertrophied = تطوّر بإفراط
Hypertrophies = تضخّم في نموّ عضو
Hypertrophy = التضخّم
Hypervelocity = السّرعة المفرطة
Hypes = أعمال الدعاية
Hyphen = الشرطة
Hyphenate = وصّل
Hyphenated = موصّل
Hyphenates = يوصّل
Hyphenating = التوصيل
Hyphenation = التشريط
Hyphenations = التشريط
Hyphened = موصّل
Hyphening = التوصيل
Hyphens = الشرطات
Hypnoses = التناويم المغناطيسية
Hypnosis = التنويم المغناطيسي
Hypnotic = منوّم
Hypnotically = على نحو منوّم مغنطيسيًّا
Hypnotics = المنوّمون
Hypnotism = التنويم المغناطيسي
Hypnotisms = التنويم المغناطيسي
Hypnotist = المنوّم المغناطيسي
Hypnotizable = قابل للتنويم المغناطيسي
Hypnotize = نوّم
Hypnotized = منوّم
Hypnotizes = ينوّم
Hypnotizing = التنويم
Hypo = الهيبوسلفات
Hypoactive = على نحو كسول
Hypocellularity = إمتلاك خلايا قليلة
Hypochlorite = هيبوكلورايت - حمض
Hypochlorous = هيبوكلوروس
Hypochondria = الوسواس
Hypochondriac = وسواسي
Hypocrisies = النّفاق
Hypocrisy = النفاق
Hypocrite = المنافق
Hypocrites = المنافقون
Hypocritic = نفاقي
Hypocritical = منافق
Hypocritically = بشكل منافق
Hypocycloid = الخطّ الناتج عن نقطة على الدّائرة التي تتدحرج داخل دائرة أخرى
Hypodermic = تحت الجلد
Hypodermics = هيبودرميس
Hypophyseal = هيبوفيسيل
Hypophysectomized = بلا غدّة نخاميّة
Hypotenuse = وتر الزاوية قائمة
Hypotenuses = أوتار الزوايا القائمة
Hypothalamic = الجزء من المخّ تحت المهاد البصريّ
Hypothalamically = متعلق بالهايبوتلاموس
Hypothalamus = الهايبوتلاموس
Hypothecate = يضع فرضيّة
Hypothecated = وضع فرضيّة
Hypothecates = يضع فرضيّة
Hypothecating = وضْع فرضيّة
Hypothermia = إنخفاض درجة الحرارة
Hypotheses = الفرضيات
Hypothesis = الفرضية
Hypothesize = إفترض
Hypothesized = مفترض
Hypothesizes = يفترض
Hypothesizing = الإفتراض
Hypothetic = إفتراضي
Hypothetical = إفتراضي
Hypothetically = إفتراضيا
Hypothyroid = متعلق بالقصور الدّرقيّ
Hypothyroidism = القصور الدّرقيّ
Hysterectomies = استئصالات الرّحم
Hysterectomy = استئصال الرّحم
Hysteresis = التخلفية
Hysteria = الهستيريا
Hysteric = هستيري
Hysterical = هستيري
Hysterically = بشكل هستيري
Hysterics = النوبات الهستيرية
Hz = الهيرتز
Human capital = القوى البشرية العاملة
Headscarves = أوشحة تغطي الرأس
Helpdesk = جهة تقوم بتزويد المساعدة والدّعم الفنّي لمستخدمي الكمبيوتر
Hsn = محطّة تلفزيونيّة تعني بالتّسوق والتّبضّع عن طريق عرض البضاعة على شاشة التلفزيون
Halal = لحم حلال :: مذبوح حسب الشريعة الإسلامية :: مباح
I = آي - الحرف التاسع في اللغة الإنجليزية، انا
I-section = أقسّم
I.e = وبمعنى آخر
IA = ولاية أيوا
Iambic = الإيامبي
Ian = إيان
Iberia = إيبريا
Iberian = آيبيري
Ibero = إبيرو
Ibex = الوعل
Ibexes = الوعول
Ibid = في نفس المكان
Ibis = أبو منجل
Ibises = آباء منجل
IBM = شركه اي بي ام
Ibn = إبن
Ibsen = إبسن
Icarus = إكاروس
ICC = غرفة التجارة العالمية
Ice = الثلج
Ice-cream = الآيس كريم
Iceberg = الجبل الثلجي
Icebergs = الجبال الثلجية
Iceboat = عربة للتزحلق على الجليد
Icebound = محاط بالجليد
Icebox = الثلاجة
Iceboxes = الثلاجات
Icebreaker = كاسحة الجليد
Icecold = شديد البرودة
Iced = مجمّد
Iceland = آيسلندا
Icelander = الآيسلندي
Icelandic = الآيسلندي
Iceman = رجل الثلج
Icemen = بائعو الثّلج
Ices = الثلوج
Ichneumon = النّمس
Ichor = دم الإله - أساطير يونانيّة
Icicle = رقاقة الثلج
Icicles = رقاقات الثلج
Icier = أثلج
Iciest = أثلج
Icily = ثلجيا
Iciness = التثلّج
Icing = التغطية بالسكر
Icings = التغطية بالسكر
Icky = رديء
Icon = الأيقونة
Iconic = أيقوني
Iconoclasm = تحطيم المعتقدات التّقليديّة
Iconoclast = الثّائر
Iconoclastic = متمرّد
Iconoclasts = الثّوّار
Icons = الأيقونات
Icosahedra = متعدّد السّطوح ذو 20 وجهًا
Icosahedral = متعلق بمتعدّد السّطوح ذو 20 وجهًا
Icosahedron = العشروني الوجوه
Icy = متجمّد
Id = بطاقة الهوية الشخصية
Ida = إدا
Idaho = إداهو
IDE = بيئة تطوير متكاملة
Idea = الفكرة
Ideal = مثالي
Idealism = المثالية
Idealist = المثالي
Idealistic = مثالي
Idealistically = مثاليا
Idealists = المثاليون
Idealization = التمثيل
Idealizations = التمثيل
Idealize = مثّل
Idealized = مثالي
Idealizer = الحالم
Idealizers = الحالم
Idealizes = يمثّل
Idealizing = التمثيل
Ideally = مثاليا
Ideals = النماذج
Ideas = الأفكار
Ideate = تصوّر
Ideates = يتصوّر
Ideation = التّفكير
Idem = مثله
Idempotent = كما لو استخدم مرّة واحدة فقط
Idempotents = كما لو استخدموا مرّة واحدة فقط
Identic = مماثل
Identical = مماثل
Identically = بشكل مماثل
Identicalness = التشابه
Identifiable = مميّز
Identifiably = بطريقة محدّدة
Identification = التعريف
Identifications = التعريفات
Identified = مميّز
Identifier = المعرّف
Identifiers = المعرّفون
Identifies = يميّز
Identify = ميّز
Identifying = التمييز
Identities = الهويّات
Identity = الهوية
Ideolect = إديوليكت
Ideologic = إديولوجيك
Ideological = أيديولوجي
Ideologically = فكريا
