Ideologies = العقائد
Ideologist = المذهبي
Ideologists = المذهبيون
Ideologue = المذهبي
Ideology = العقيدة
Idiocies = الحماقات
Idiocy = البلاهة
Idiolect = اللّهجة
Idiom = التعبير
Idiomatic = تعبيري
Idiomatically = بشكل تعبيري
Idioms = التعابير
Idiopathic = مجهول العلّة
Idiosyncrasies = الخواص
Idiosyncrasy = الخاصية
Idiosyncratic = تمييزي
Idiosyncratically = بشكل تمييزي
Idiot = الأبله
Idiotic = غبي
Idiotically = بغباء
Idioticly = بشكل غبي
Idiots = البلهاء
Idle = عاطل
Idled = مضيع
Idleness = التسيّب
Idler = العاطل
Idlers = العاطلون
Idles = يضيع
Idlest = عاطل
Idling = الضياع
Idly = بكسل
Idol = المعبود
Idolater = الوثني
Idolatrous = وثني
Idolatrously = بشكل وثني
Idolatrousness = الوثنيّة
Idolatry = عبادة الأصنام
Idolization = العبادة
Idolize = إعبد
Idolized = معبود
Idolizer = العابد
Idolizers = العابدون
Idolizes = يعبد
Idolizing = العبادة
Idols = الأصنام
Idyll = القصيدة الرعوية
Idyllic = شاعري
Idyllically = بانشراح
Idylls = القصائد الرعوية
Ie = أو بمعنى اخر..
IEEE = معهد مهندسي الكهرباء والإلكترونيات
If = إذا
Iffiness = التشكّك
Iffy = متشكّك
Ifni = إيفني
Igloo = كوخ الإسكيمو
Igloos = أكواخ الإسكيمو
Igneous = ناري
Ignite = أشعل
Ignited = مشعل
Igniter = الشاعل
Ignites = يشعل
Igniting = الإشعال
Ignition = الإيقاد
Ignitions = الإيقاد
Ignoble = دنيئ
Ignobleness = الحقارة
Ignobly = بحقارة
Ignominies = الفضائح
Ignominious = مخزي
Ignominiously = بشكل مخزي
Ignoramus = الجهول
Ignoramuses = الجهلة
Ignorance = الجهل
Ignorant = الجاهل
Ignorantly = بشكل جاهل
Ignorantness = الجهل
Ignore = أهمل
Ignored = مهمل
Ignorer = الغير مهتم
Ignores = يهمل
Ignoring = الإهمال
Igor = إيغور
Iguanas = الإيغوانات
Ii = الثّاني
Iid = آلة تشابك المشغّل
Iii = الثّالث
Ike = آيك
IL = إلينوي
Ileum = المعي اللفائفي
Ileus = الشلل اللفائفي
Ileuses = الشلل اللفائفي
Ilia = إليا
Iliac = حرقفي
Iliad = إلياذة هوميروس
Ilium = إليوم
Ilk = الجنس
Ill = المرض
Ill-favoured = قبيح
Illbred = وقح
Illegal = غير شرعي
Illegalities = الانتهاكات
Illegality = الغير شرعية
Illegally = بشكل غير قانوني
Illegibility = غموض الخط
Illegible = غير مقروء
Illegibly = بصورة تصعب قراءتها
Illegitimacy = النغولة
Illegitimate = غير شرعي
Illegitimately = بشكل غير شرعي
Illgotten = حرام
Illiberal = ضيّق الآفق
Illiberally = بشكل ضيّق الآفق
Illicit = محظور
Illicitly = بشكل محظور
Illimitability = اللاحدودية
Illimitable = بلا حدود
Illimitableness = اللامحدود
Illimitably = بشكل لا متناه
Illinois = إلينوي
Illiteracy = الأميّة
Illiterate = أمّي
Illiterately = أميا
Illiterateness = الأميّة
Illiteratenesses = الأميّة
Illiterates = الأميّون
Illness = المرض
Illnesses = الأمراض
Illogic = اللّامنطقيّة
Illogical = غير منطقي
Illogically = بشكل غير منطقي
Illogicalness = اللا منطقية
Ills = الأمراض
Illume = أنر
Illumed = منار
Illumes = ينير
Illuminable = قابل للإضاءة
Illuminance = الإضاءة
Illuminate = منوّر
Illuminated = منار
Illuminates = ينير
Illuminating = الإضاءة
Illuminatingly = بشكل منير
Illumination = الإضاءة
Illuminations = أنوار الزينة
Illuminative = مضيئ
Illuminator = الضوء
Illuminators = الأضواء
Illumine = أنر
Illumined = منار
Illumines = ينير
Illuming = الإنارة
Illumining = الإنارة
Illusion = الوهم
Illusionary = وهمي
Illusions = الأوهام
Illusive = خدّاع
Illusively = بشكل خدّاع
Illusiveness = الخداع
Illusivenesses = الخداع
Illusorily = بشكل خدّاع
Illusoriness = الزّيف
Illusory = خدّاع
Illust = الصّورة
Illustrate = صوّر
Illustrated = مصوّر
Illustrates = يصوّر
Illustrating = التصوير
Illustration = الإيضاح
Illustrations = الإيضاحات
Illustrative = إيضاحي
Illustratively = بشكل إيضاحي
Illustrator = المصور
Illustrators = المصورون
Illustrious = شهير
Illustriously = بشكل شهير
Illustriousness = اللمعان
Illy = إلي
Ilona = إلونا
Ilyushin = إليشين
Image = الصورة
Image-File = ملف صورة
Image-Type = من نوع صورة
ImageCanvas = مساحة الصورة
Imaged = معكوس
Imageries = الصور
Imagery = الصورة
Images = الصور
Imaginable = قابل للتخيل
Imaginableness = الإمكانية
Imaginably = بصورة خياليّة
Imaginariness = الخيالية
Imaginary = خيالي
Imaginate = خياليّ
Imagination = الخيال
Imaginations = التخيلات
Imaginative = مبدع
Imaginatively = بشكل خلاّق
Imaginativeness = التّخيّل
Imagine = تخيّل
Imagined = متخيّل
Imaginer = المتخيّل
Imagines = يتخيّل
Imaging = التصوير
Imagining = التخيّل
Imbalance = عدم التوازن
Imbalances = حالات عدم التوازن
Imbecile = أبله
Imbecilely = بشكل أبله
Imbeciles = البلهاء
Imbecilic = أبله
Imbecilities = إمبيسيليتيس
Imbecility = البلاهة
Imbed = إطمر
Imbedding = الطمر
Imbeds = يطمر
Imbibe = إشرب
Imbibed = مشروب
Imbiber = المتجرّع
Imbibes = يشرب
Imbibing = الشرب
Imbroglio = الفوضى
Imbroglios = الورطة
Imbrue = ضرّج
Imbrued = مضرّج
Imbrues = يضرّج
Imbruing = التضريج
Imbue = شبّع
Imbued = مشبّع
Imbues = يشبّع
Imbuing = التشبّع
Imitable = قابل للتّقليد
Imitate = قلّد
Imitated = مقلّد
Imitates = يقلّد
Imitating = التقليد
Imitation = التقليد
Imitations = التقليد
Imitative = تقليدي
Imitatively = بشكل تقليدي
Imitativeness = التّقليد
Imitator = المقلّد
Imitators = المقلدون
Immaculate = نظيف جدا
Immaculately = بنظافة شديدة
Immaculateness = النظافة الشديدة
Immanence = اللزوم
Immanent = جوهري
Immanently = بشكل جوهري
Immaterial = غير أساسي
Immaterially = بشكل غير أساسي
Immaterialness = اللامادية
Immature = غير ناضج
Immaturely = بشكل غير ناضج
Immatureness = عدم النضوج
Immaturity = عدم النضج
Immeasurable = بلا حدود
Immeasurableness = اللامحدودية
Immeasurably = بلا حصر
Immediacies = الآنية
Immediacy = الآنية
Immediate = فوري
Immediately = فورا
Immediateness = الآنية
Immediatly = حالا
Immemorial = سحيق
Immemorially = بشكل سحيق
Immense = هائل
Immensely = كثيرا
Immenseness = الضخامة
Immensities = الأبعاد الهائلة
Immensity = الضخامة
Immerse = إغطس
Immersed = غاطس
Immerses = يغطس
Immersing = الغطس
Immersion = الغمر
Immersions = الغمر
Immigrant = المهاجر
Immigrants = المهاجرون
Immigrate = هاجر
Immigrated = مهاجر
Immigrates = يهاجر
Immigrating = الهجرة
Immigration = الهجرة
Immigrations = دوائر الهجرة
Imminence = الوشاكة
Imminent = وشيك
Imminently = قريبا جدا
Imminentness = على وشك
Immiscible = غير قابل للإمتزاج
Immobile = ثابت
Immobilisation = الشلّ
Immobility = التعوّق
Immobilize = شلّ
Immobilized = مشلول
Immobilizer = المثبت عن الحركة
Immobilizes = يشلّ
Immobilizing = الشلّ
Immoderate = مفرط
