Ink-jet = طائرة حبر
Ink-pad = وسادة حبر
Ink-pencil = قلم رصاص حبر
Inkblot = بقعة حبر
Inked = محبّر
Inker = المحبّر
Inkers = المحبّرات
Inkier = محبّر
Inkiest = محبّر
Inking = التحبير
Inkling = الفكرة
Inklings = الأفكار
Inks = الأحبار
Inkstand = المحبرة
Inkwell = المحبرة
Inky = محبّر
Inlaid = مطعّم
Inland = داخل البلاد
Inlander = داخلي
Inlands = داخل البلاد
Inlay = البطانة
Inlayer = المبطّن
Inlaying = التطعيم
Inlays = البطانات
Inlet = الفتحة
Inlets = الفتحات
Inlier = كتلة صخور يُحَيط بها صخور أصغر في العمر
Inly = داخليًّا
Inlying = داخلي
Inman = إنمان
Inmate = النزيل
Inmates = النزلاء
Inmost = أعمق
Inn = الحانة
Innards = المصارين
Innate = فطري
Innately = بشكل فطري
Innateness = الفطرة
Inner = الداخل
Innerly = بشكل داخلي
Innermost = أعمق
Innervate = عصّب
Innervated = معصّب
Innervates = يعصّب
Innervating = التعصيب
Inning = الجولة
Innings = الجولات
Innkeeper = صاحب الحانة
Innocence = البراءة
Innocense = إينوسينس - زهرة
Innocent = بريء
Innocently = بشكل بريء
Innocents = الأبرياء
Innocuous = غير مؤذي
Innocuously = بشكل غير مؤذي
Innocuousness = السلامة
Innovate = إبتدع
Innovated = مبتدع
Innovates = يبتدع
Innovating = الإبتداع
Innovation = الإبداع
Innovations = الإبداع
Innovative = إبداعي
Innovativeness = الإبتكار
Innovator = المبتكر
Innovators = المبتكرون
Innoxious = غير مؤذي
Innoxiously = بشكل غير مؤذي
Inns = الحانات
Innuendo = الإساءة المبطّنة
Innuendoes = الإساءات المبطّنة
Innuendos = الإساءة المبطّنة
Innumerability = بشكل غير محدود
Innumerable = غير معدود
Innumerableness = اللامعدودية
Innumerably = بطريقة لا تعدّ
Inoculate = تلقّح
Inoculated = تلقّح
Inoculates = يتلقّح
Inoculating = التلقيح
Inoculation = التلقيح
Inoculations = التصحيحات
Inoculative = تلقيحي
Inoffensive = غير مؤذي
Inoffensively = على نحو مسالم
Inoffensiveness = عدم الإيذاء
Inoperable = غير صالح للعملية
Inoperative = عديم المفعول
Inoperativeness = حالة الجهاز العطلان
Inopportune = غير مناسب
Inopportunely = بشكل غير مناسب
Inopportuneness = سوء التّوقيت
Inordinacy = الزّيادة
Inordinate = غير منتظم
Inordinately = بشكل غير منتظم
Inordinateness = الزّيادة
Inorganic = لا عضوي
Inorganically = لا عضويا
Inpatient = النّزيل
Inpatients = النّزلاء
Input = المساهمة
Input-output = المدخلات المخرجات
Inputing = الإدخال
Inputoutput = إدخالإخراج
Inputs = المساهمات
InputSlot = منفذ الإدخال
Inputted = أدخل
Inputting = الإدخال
Inquest = التحقيق
Inquests = التحقيقات
Inquietude = القلق
Inquire = إستفسر
Inquired = مستفسر
Inquirer = المستعلم
Inquirers = المستعلمون
Inquires = يستفسر
Inquiries = التحقيقات
Inquiring = الإستفسار
Inquiringly = بشكل مستفسر
Inquiry = التحقيق
Inquiry-response = ردّ تحقيق
Inquisition = الإستقصاء
Inquisitional = متعلق بالمحكمة
Inquisitions = الإستقصاء
Inquisitive = فضولي
Inquisitively = بشكل فضولي
Inquisitiveness = الفضول
Inquisitor = المحقّق
Inquisitorial = إستقصائي
Inquisitorially = بشكل إستقصائي
Inquisitors = المحقّقون
Inroad = الغارة
Inroads = الغارات
Inrun = المسار الجليدي المنحدر الذي يقطعه المتزلج لزيادة سرعته قبل القفز من على حافّة المنحدر
Inrushing = التّدفّق
INS = مكتب خادمات الهجرة
Insalubrious = غير صحّي
Insane = مجنون
Insanely = بشكل مجنون
Insaneness = الجنون
Insanitary = غير صحّي
Insanity = الجنون
Insatiability = الجشع
Insatiable = جشع
Insatiableness = الطّمع
Insatiably = بجشع
Insatiate = نهم
Insatiately = بِنَهَمْ
Insatiateness = حالة الشّرِهْ
Inscribe = إكتب
Inscribed = مكتوب
Inscriber = النقاش
Inscribes = يكتب
Inscribing = الكتابة
Inscription = النقش
Inscriptions = النقوش
Inscrutability = الغموض
Inscrutable = غامض
Inscrutableness = الغموض
Inscrutably = بغموض
Insect = الحشرة
Insecticide = مبيد الحشرات
Insecticides = مبيدات الحشرات
Insectivore = إنسيكتيفور
Insectivorous = آكل الحشرات
Insects = الحشرات
Insecure = غير آمن
Insecurely = بشكل غير آمن
Insecureness = عدم الإطمئنان
Insecurities = حالات عدم الأمان
Insecurity = عدم الأمان
Inseminate = لقّح
Inseminated = ملقّح
Inseminates = يلقّح
Inseminating = التلقيح
Insemination = التلقيح
Inseminations = التلقيح
Insensate = عديم الحس
Insensately = بشكل عديم الحس
Insensateness = إنعدام الإحساس
Insensibility = عدم الإحساس
Insensible = عديم الحس
Insensibleness = عدم الإدراك
Insensibly = بعدم إكتراث
Insensitive = عديم الحس
Insensitively = بشكل عديم الحس
Insensitiveness = عدم الحساسية
Insensitivity = البرود
Insentient = عديم الحسّ
Inseparability = التلازم
Inseparable = متلازم
Inseparableness = التلازم
Inseparably = بشكل غير منفصل
Insert = الملحق، ادخل، يدخل
Inserted = مدخل
Inserter = الواضِع بين
Inserting = الإدخال
Insertion = الإدخال
Insertions = الإدخال
Inserts = الملاحق
Inset = الشكل
Insets = الأشكال
Insetting = الإدراج
Inshore = ساحلي
Inside = داخل
Insider = المطلّع بشؤون
Insiders = المطّلعون بشؤون
Insides = الدواخل
Insidious = ماكر
Insidiously = بشكل ماكر
Insidiousness = المكر
Insight = البصيرة
Insightful = ذو بصيرة
Insightfully = بتبصّر
Insightfulness = التبصّر
Insights = البصائر
Insignia = الشارة
Insignias = الشارة
Insignificance = التفاهة
Insignificances = التفاهة
Insignificant = تافه
Insignificantly = بتفاهة
Insincere = منافق
Insincerely = بشكل منافق
Insincerities = النفاق
Insincerity = النفاق
Insinuate = دسّ
Insinuated = مدسوس
Insinuates = يدسّ
Insinuating = الدسّ
Insinuatingly = تلميحيا
Insinuation = التلميح
Insinuations = التلميحات
Insinuative = دسّي
Insipid = عديم الطعم
Insipidity = التفاهة
Insipidly = بشكل عديم الطعم
Insipidness = التفاهة
Insist = أصرر
Insisted = مصرّ
Insistence = الإصرار
Insistency = الإلحاح
Insistent = مصرّ
Insistently = بشكل مصرّ
Insisting = الإصرار
Insists = يصرّ
Insobriety = السكر
Insociability = بصورة غير إجتماعية
Insociable = انطوائيّ
Insociably = بصورة إنطوائية
Insofar = لدرجة أنّ
Insolation = التعرّض للشمس
Insole = النعل الداخلي
Insolence = الوقاحة
Insolent = وقح
Insolently = بشكل وقح
Insoles = النعال الداخلية
Insolubility = الصلابة
Insoluble = عديم الذوبان
Insolubleness = الصلابة
Insolubly = بصورة لا يتم فيها الذوبان
Insolvable = متعذّر حلّ
Insolvencies = الإفلاس
Insolvency = الإفلاس
Insolvent = المفلس
Insolvently = بشكل مفلس
Insomnia = الأرق
Insomniac = المؤرق
Insomniacs = المؤرقون
Insomuch = إلى حدّ
Insouciance = عدم المبالاة
Insouciant = لا مبالي
Insouciantly = بشكل لا مبالي
Inspect = فتّش
Inspected = مفتّش
Inspecting = التفتيش
Inspection = التفتيش
Inspections = عمليات التفتيش
Inspective = متعلق بالتفتيش
Inspector = المفتش
Inspectors = المفتشون
Inspects = يفتّش
Inspiration = الإلهام
Inspirational = إلهامي
Inspirationally = بشكل إلهامي
Inspirations = الإلهام
Inspire = ألهم
Inspired = ملهم
Inspirer = الملهم
Inspires = يلهم
Inspiring = الإلهام
Inspiringly = بإلهام
Inspirit = ألهم
Instabilities = عدم الإستقرار
Instability = عدم الإستقرار
Instable = متغيّر
Install = ركّب
Installable = قابل للتّثبيت
Installation = التركيب
Installations = التجهيزات
