Invigorated = منشّط
Invigorates = ينشّط
Invigorating = التنشيط
Invigoratingly = بحيويّة
Invigoration = الإنتعاش
Invigorations = الإنتعاش
Invincibility = المناعة
Invincible = منيع
Invincibleness = اللاقهر
Inviolability = الحصانة
Inviolable = منيع
Inviolableness = المناعة من الإختراقات
Inviolably = بلا إختراقات
Inviolacy = السلامة، لم يُمس من قِبَل الاخرين
Inviolate = منيع
Inviolately = بشكل منيع
Inviolateness = السلامة، لم يُمس
Invisibility = الخفاء
Invisible = مخفي
Invisibleness = الإختفاء
Invisibly = بخفاء
Invitation = الدعوة
Invitational = مقصور للمدعوين فقط
Invitations = الدعوات
Invite = إدع
Invited = مدعو
Invitee = المدعو
Invitees = المدعوون
Inviter = الداعي
Invites = الدعوات
Inviting = الدعوة
Invitingly = بشكل ممتع
Invocate = ينادي على، يستشهد بـ
Invocation = الدعاء
Invocations = الدعوات
Invoice = الفاتورة
Invoiced = منظّم فاتورة
Invoices = الفواتير
Invoicing = تنظيم فاتورة
Invoke = تضرّع
Invoked = متضرّع
Invoker = المنادي على، المستشهد بـ
Invokers = المنادون على، المستشهدون بـ
Invokes = يتضرّع
Invoking = التضرّع
Involuntarily = تلقائيا
Involuntariness = اللّاإراديّة
Involuntary = تلقائي
Involute = مطوي
Involuted = مطوي
Involutely = بشكل مطوي
Involution = الإلتفاف
Involutions = الإلتفاف
Involve = تضمّن
Involved = ذو علاقة
Involvedly = بشكل ذو علاقة
Involvement = التدخّل
Involvements = الإرتباطات
Involver = المُحتوي على، المشارك بـ
Involves = يتضمّن
Involving = التضمين
Invulnerability = الحصانة
Invulnerable = منيع
Invulnerableness = المناعة
Invulnerably = بقوّة
Inward = داخلي
Inwardly = داخليا
Inwardness = الجوهر
Inwards = إلى الداخل
Inwrought = مزخرف
Io = أيو - البكر التي أُحِبهاَّ زيوس - أساطير يونانيّة
IO-Port = نافذة الإدخال والإخراج
IO-Range = مجال الإدخال والإخراج
Ioctl = التحكّم بالداخل والخارج - برمجيّات
Iodate = يعالج بـ اليود
Iodated = عالج بـ اليود
Iodating = المعالجة بـ اليود
Iodation = المعالجة بـ اليود
Iodide = اليوديد
Iodinate = عالج باليود
Iodinated = معالج بـ اليود
Iodinating = المعالجة بـ اليود
Iodination = المعالجة بـ اليود
Iodine = اليود
Ion = الآيون
Ionic = أيوني
Ionisation = التأيّن
Ionizable = قابل للتأين
Ionization = التأيّن
Ionize = أيّن
Ionized = مؤيّن
Ionizer = المؤيّن
Ionizes = يأيّن
Ionizing = التأيين
Ionosphere = الأيونوسفير
Ionospheric = أيونوسفيري
Ions = الآيونات
Iota = الأيوتا
Iotas = الأيوتا
Iou = وعد بدفع الدين أو المستحقات
Iowa = آيوا
Ipecac = إيبيكا - شجيرة أمريكيّة استوائيّة
Ipsilateral = متعلق بـ نفس الجانب من جسم الإنسان
Ipso = إيبسو - منظّمة الدّراسات التّحليليّة الدّوليّة
IQ = معامل الذّكاء
IR = دون الأشعة الحمراء
Ira = الجيش الجمهوري الآيرلندي
Iran = إيران
Iranian = الإيراني
Iraq = العراق
Iraqi = العراقي
Irascibility = سرعة التهيّج
Irascible = غضوب
Irascibleness = سرعة الغضب
Irascibly = غضوبا
Irate = غاضب
Irately = بغضب شديد
Irateness = السّخط
Ire = الغضب
Ireland = إيرلنده
Irene = إرين
Ires = الغضب
Iridescence = متخيّف الألوان
Iridescent = قزحي الألوان
Iridescently = قزحيا
Iridium = الإيريديوم
Iris = آيريس
Irises = القزحيّات
Irish = آيرلندي
Irishman = الآيرلندي
Irishmen = الآيرلنديون
Irishwoman = الآيرلندية
Irk = أتعب
Irked = متعب
Irking = الإتعاب
Irks = يتعب
Irksome = شاق
Irksomely = بمشقّة
Irksomeness = الملل
Irma = إرما
Iron = الحديد
Ironclad = المدرعة
Ironed = مكوي
Ironer = حديدي
Ironic = ساخر
Ironical = ساخر
Ironically = من سخرية القدر
Ironicalness = التهكمية
Ironicly = بشكل ساخر
Ironies = السخريات
Ironing = الكوي
Ironings = الكوي
Ironmonger = تاجر الحديد
Ironmongers = تجار الحديد
Ironness = الحديدية
Irons = الحديد
Ironside = رجل ذو قوّة كبيرة أو شّجاعة
Ironsides = رجال ذوو قوّة كبيرة أو شّجاعة
Ironstone = حجر الحديد
Ironwood = الخشب القوي
Ironwork = الشغل الحديدي
Ironworker = الحدّاد
Ironworks = الأشغال الحديدية
Irony = السخرية
Iroquois = إيروكويس - أمريكيّ أصليّ يسكن ولاية نيويورك
Irradiance = الإشعاع
Irradiate = أضئ
Irradiated = مضاء
Irradiates = يضيئ
Irradiating = الإضاءة
Irradiation = الإنارة
Irradiative = مشعّ
Irrational = لا عقلاني
Irrationality = اللا عقلانية
Irrationally = بشكل لا عقلاني
Irrationalness = اللا منطقية
Irrationals = اللا عقلانيون
Irrawaddy = إيراوادي - نهر في  ميانمار
Irreclaimable = غير قابل للإسترداد
Irreclaimably = لا يمكن إسترجاعه
Irrecognizable = متعذّر التمييز
Irreconcilability = التناقض
Irreconcilable = متناقض
Irreconcilableness = اللا قابلية للحلّ
Irreconcilably = بشكل متناقض
Irrecoverable = لايسترد
Irrecoverableness = إنعدام قدرة الإسترجاع
Irredeemability = فقدان القدرة على التعويض
Irredeemable = لايعوّض
Irredeemableness = عدم إمكانية التعويض
Irredeemably = بشكل لا يعوّض
Irredentism = الوحدويّة
Irredentist = تحرريّ
Irreducible = متعذر الإنقاص
Irreducibly = بشكل غير قابل للإنقاص
Irreflexive = غير متبادل
Irrefragable = غير قابل للدحض
Irrefragably = بصورة معروفة
Irrefutability = اللاتناقضية
Irrefutable = غير قابل للدحض
Irrefutably = بشكل لايقبل الجدل
Irregardless = بالرّغم من كل شيئ
Irregular = شاذ
Irregularities = المخالفات
Irregularity = المخالفة
Irregularly = بدون إنتظام
Irregulars = إريجولارس
Irrelevance = اللا علاقية
Irrelevances = التفاهات
Irrelevancies = التّفاهات
Irrelevancy = اللا علاقية
Irrelevant = غير ذو علاقة
Irrelevantly = بشكل غير ذو علاقة
Irreligiously = بشكل غير متدين
Irremediable = عضال
Irremediableness = لا قابلية للعلاج
Irremediably = بشكل غير قابل للعلاج
Irremovability = إنعدام قدرة التحريك
Irremovable = ثابت
Irreparability = إنعدام قدرة الإصلاح
Irreparable = متعذر الإصلاح
Irreparableness = العطل الذي لايمكن إصلاحه
Irreparably = بشكل يعجز إصلاحه
Irreplaceable = متعذر الإبدال
Irreplaceableness = إنعدام قدرة الإبدال
Irreplaceably = بطريقة لا تستبدل
Irrepressible = متعذر الكبت
Irrepressibly = بحيويّة
Irreproachability = تحاشي الأخطاء
Irreproachable = نزيه
Irreproachableness = النزاهة
Irreproachably = بشكل لا غبار عليه
Irreproducibility = عدم إمكانية الحصول على
Irreproducible = غير متكاثر
Irresistibility = عدم المقاومة
Irresistible = لا يقاوم
Irresistibleness = عدم المقاومة
Irresistibly = بشكل لا يقاوم
Irresolute = متردّد
Irresolutely = بشكل متردّد
Irresoluteness = التردد
Irresolution = التردد
Irresolutions = الترددات
Irresolvable = متعذر الحلّ
Irrespective = بغضّ النّظر
Irrespectively = بغض النظر عن
Irresponsibility = عدم الشعور بالمسؤلية
Irresponsible = لامبالي
Irresponsibleness = عدم الإكتراث
Irresponsibly = بلا مسؤولية
Irretrievable = غير قابل للإسترجاع
Irretrievableness = الفقدان إلى الأبد
Irretrievably = بلا عودة
Irreverence = الإستخفاف
Irreverent = عديم الإحترام
Irreverently = باستخفاف
Irreversibility = إنتفاء قدرة العودة
Irreversible = غير قابل للنقض
Irreversibleness = إنتفاء القدرةعلى العودة
Irreversibly = بشكل غير قابل للنقض
Irrevocability = القطعية
Irrevocable = غير قابل للنقض
Irrevocableness = القطعية
Irrevocably = بشكل غير قابل للنقض
Irrigate = إسق
Irrigated = مسقي
Irrigates = يسقي
Irrigating = السقاية
Irrigation = الريّ
Irrigations = الريّ
Irritabilities = التهيّجات
Irritability = الطيش
Irritable = عصبي
Irritableness = سرعة الغضب
Irritably = بانفعال
Irritant = مثير
Irritants = المهيّجات
Irritate = أغضب
Irritated = مغضب
Irritates = يهيّج
Irritating = التهيّج
Irritatingly = بشكل مزعج
Irritation = التهيّج
Irritations = التهيّج
Irritative = مثير
Irrupt = يخرج بقوة - كما البركان
Irrupted = خرج بقوة - كما البركان
Irrupting = الخروج بقوة - كما البركان
Irruption = الإقتحام
Irruptions = الإقتحام
Irruptive = إقتحامي
Irruptively = بشكل إقتحامي
Irrupts = يخرج بقوة - كما البركان
IRS = مكتب خادمات الأموال الداخليه
Irvin = إرفين
Irvine = إرفين
Irving = إرفينج
Irwin = إروين
Is = هل
Isaac = إسحاق
