Legacies = الإرث
Legacy = التراث
Legal = قانوني
Legalities = القانونيّة
Legality = المشروعية
Legalization = التشريع
Legalizations = التشريع
Legalize = شرّع
Legalized = مشروع
Legalizes = يشرّع
Legalizing = التشريع
Legally = قانونيا
Legate = المندوب
Legated = ليجاتيد
Legatee = المورّث
Legates = المندوبون
Legating = الإنابة، التمثيل
Legation = المفوّضية
Legations = المفوّضيات
Legato = منبّسط ومتساوي
Legend = الأسطورة
Legendary = أسطوري
Legendre = ليجيندر - عالم رياضيّات فرنسيّ
Legends = الأساطير
Legerdemain = خفة اليد
Legged = ذو أرجل
Leggier = طويل الساقين
Legging = يغطي الرٍّجْل
Leggings = اللباس الداخلي
Leggy = طويل الساقين
Leghorn = القبعة
Legibility = الوضوح
Legible = واضح
Legibleness = مقروء
Legibly = بوضوح
Legion = الجحفل
Legionaries = أعضاء الفيلق
Legionary = عضو الفيلق
Legionnaire = الجندي
Legions = الجحافل
Legislate = شرّع
Legislated = مشرّع
Legislates = يشرّع
Legislating = التشريع
Legislation = التشريع
Legislations = التشريعات
Legislative = تشريعي
Legislatively = تشريعيا
Legislator = المشرّع
Legislators = المشرّعون
Legislature = المجلس التشريعي
Legislatures = السلطات التشريعية
Legit = شرعي
Legitimacy = الشرعية
Legitimate = شرعي
Legitimated = مشرّع
Legitimately = بشكل شرعي
Legitimateness = الشرعية
Legitimates = يشرّع
Legitimating = التشريع
Legitimation =  التقنين
Legitimization = التّشريع
Legitimize = شرّع
Legitimized = مشرّع
Legitimizer = المشرّع
Legitimizes = يشرّع
Legitimizing = التشريع
Legs = السيقان
Legume = قرن النبات
Legumes = قرون النبات
Leguminous = بقلي
Lehigh = ليهاي
Lehman =  ليمان - مصرفيّ و سياسيّ أمريكيّ
Leigh = لاي
Leighton = لايتن
Leila = ليلى
Leiser = ليايزر
Leisure = الراحة
Leisured = مترف
Leisureliness = الراحة
Leisurely = مترف
Leitmotif = النزعة المتكررة
Leitmotiv = الفكرة المتكررة
Leland = ليلند
Lemke = ليمكي
Lemma = قضيّة تساعد في تسهيل أمور قضية أخرى :: القضيّة المساعدة
Lemmas = قضايّا تساعد في تسهيل أمور قضية أخرى
Lemming = اليرنب القطبي
Lemmings = اليرانب القطبية
Lemon = الليمون
Lemon-juice = عصير الليمون
Lemonade = شراب الليمون
Lemons = الليمون
Lemuel = ليمل - ملك تفرّغ لعبادة اللة
Len = لين
Lena = لينا
Lend = أعر
Lender = الدائن
Lenders = الدائنون
Lending = الإقراض
Lends = يعير
Length = الطول
Lengthen = طوّل
Lengthened = مطوّل
Lengthener = المُمدّد
Lengthening = التطويل
Lengthens = يطوّل
Lengthier = أكثر تطويلا
Lengthily = بشكل مطوّل
Lengthiness = التّطويل
Lengths = الأطوال
Lengthwise = طوليا
Lengthy = طويل
Leniency = التساهل
Lenient = متساهل
Leniently = بتساهل
Lenin = لينين
Leningrad = لينينغراد
Leninism = اللينينية
Leninist = اللينيني
Lenitive = مسكّن
Lennox = لينيكس
Lenny = ليني
Lenore = لينور
Lens = العدسة
Lense = لينس
Lensed = بعدسات
Lenser = لينسير
Lenses = العدسات
Lensing = يصوّر فوتوغرافيا
Lent = الصوم الكبير
Lenten = صومي
Lenticular = عدسي
Lentil = العدس
Lentils = العدس
Leo = ليو
Leon = ليون
Leona = ليونا
Leonard = ليونارد
Leonardo = ليوناردو
Leone = ليون
Leonid = ليوند
Leonine = أسدي
Leopard = النمر
Leopards = النمور
Leopold = ليوبولد
Leopoldville = ليوبولدفيل
Leotard = الملابس اللاصقة للاعبي الجمباز
Leper = المصاب بداء الجذام
Lepers = المصابون بداء الجذام
Lepidolite = اللبيدوليت - معدن من مجموعة الميكا
Leprechaun = الجني
Leprosy = مرض الجذام
Leprous = جذامي
Leprously = بشكل جذامي
Lern = منطقة الإستجابة للطّوارئ المحلّيّة
Leroy = ليروي
Lesbian = السحاقية
Lesbians = السحاقيات
Lesion = الأذى
Lesions = الجروح
Leslie = ليزلي
Lesotho = ليسوتو
Less = أقل
Lessee = المستأجر
Lessen = قلّل
Lessened = مستصغر
Lessening = التقليل
Lessens = يقلّل
Lesser = أقل
Lesses = المستأجرون
Lessing = ليسينج - كاتبة بريطانيّة
Lesson = الدرس
Lessoned = درّس
Lessoning = التدريس
Lessons = الدروس
Lessor = المؤجر
Lest = خشية أن
Lester = ليستر
Let = دع
Letdown = الخذلان
Lethal = قاتل
Lethality = الخطورة
Lethally = بشكل قاتل
Lethargic = خامل
Lethargically = بشكل خامل
Lethargies = الخمول
Lethargy = الخمود
Lethe = نهر النسيان
Letitia = ليتيتيا
Lets = العوائق
Letter = الرسالة
Letter-box = صندوق الرسائل
Letter-press = صحافة رسالة
Letter-quality = نوعية رسالة
Lettered = مغطّى بالحروف
Letterer = نقّاش الحروف
Letterhead = الورقة المعنّونة
Letterheads = الأوراق المعنّونة
Lettering = الترقين
Letterings = الترقين
Letterman = ليتيرمان
Lettermen = ليتيرمين
Letterpress = النصّ
Letters = الرسائل
Letting = التأجير
Lettings = الإيجارات
Lettuce = الخسّ
Leucine = ليسين - حامض أمينيّ أساسيّ
Leukemia = اللوكيميا
Leukocyte = كرة الدّم البيضاء
Lev = ليف
Levee = السدّ
Leveed = بنى سدّ
Levees = السدود
Level = المستوى
Leveled = إستوى
Leveler = مستوي
Levelers = المسوّون، المسطّحون
Levelheadedness = الإتّزان
Leveling = الإستواء
Levelled = إستوى
Leveller = المسوي
Levelling = الإستواء
Levelly = بشكل مستوي
Levelness = الإستواء
Levels = المستويات
Lever = العتلة
Leverage = قوة الرفع
Leveraged = رفع
Leverages = يرفع
Leveraging = الرفع
Levered = أخرج
Levering = الرّفع
Levers = العتلات
Levi = ليفي
Levied = مجموع
Levier = جابي الضرائب
Levies = الرسوم
Levin = البرق
Levine = ليفين - عازف بيانو و مايسترو أمريكيّ
Levis = ليفيس
Levitate = إرفع
Levitated = مرفوع
Levitates = يرفع
Levitating = الرفع
Levitation = الإرتفاع
Levitations = الإرتفاعات
Leviticus = سفر اللاويين
Levities = الهزليات
Levitt = ليفيت
Levity = الهزل
Levulose = السّكّر
Levy = ليفي
Levying = الجمع
Lew = مكان هاديء
Lewd = فاسق
Lewder = فاسق
Lewdest = فاسق
Lewdly = بشكل فاسق
Lewdness = الفجور
Lewellyn = لويلين
Lewis = لويس
Lex = ليكس
Lexical = معجمي
Lexically = بشكل معجمي
Lexicographic = معجمي
Lexicographical = معجمي
Lexicographically = بشكل معجمي
Lexicography = تأليف القواميس
Lexicon = المعجم
Lexicons = المعاجم
Lexington = ليكسنغتن
Leyden = ليدن
Liabilities = المسؤوليات
Liability = المسؤولية
Liable = مسؤول قانونيا
Liableness = التعرّض
Liably = ليابلي
Liaison = الإتصال
Liaisons = الإتصال
Liar = الكذاب
Liars = الكذابون
Lib = ليب
Libation = الإراقة
Libations = الإراقة
Libbard = الفهد
Libel = التشهير
Libeled = شهّر
Libeler = ناشر الفضائح
Libellant = المدّعي
Libellist = المدّعي
Libellous = تشهيري
Libellously = بشكل تشهيري
Libelous = تشهيري
Libelously = بشكل تشهيري
Libels = التشهير
Liberace = ليبيريس - عازف بيانو و ممثّل كوميديّ أمريكيّ
Liberal = التحرري
Liberalism = التحرّريّة
