Lunated = لاناتيد
Lunately = لاناتيلي
Lunatic = مجنون
Lunaticly = بشكل مجنون
Lunatics = المجانين
Lunation = الشهر القمري
Lunch = الغداء
Lunched = متغدّى
Luncheon = الغداء
Luncheons = الغداء
Luncher = لانتشير
Lunches = الغداء
Lunchhour = لانتشهور
Lunching = التغدّي
Lunchroom = غرفة الطعام
Lunchrooms = غرف الطعام
Lunchtime = وقت الغداء
Lund = لاند
Lundberg = لاندبيرج
Lundquist = لاندكويست
Lung = الرئة
Lunge = الطعنة
Lunged = مندفع
Lunger = لانجير
Lunges = الطعنات
Lunging = الإندفاع
Lungs = الرئتين
Lupin = الترمس
Lupine = نبات الترمس
Lupines = نباتات التّرمس
Lupins = نباتات التّرمس
Lura = لورا
Lurch = الترنّح
Lurched = مترنّح
Lurcher = الجوّاس
Lurches = الترنّح
Lurching = الترنّح
Lure = السحر
Lured = مغرى
Lurer = المستدرِج
Lures = السحر
Lurid = بشع
Luridly = بشحوب
Luridness = الصدمة
Luring = الإغراء
Luringly = باستدراج
Lurk = ترصّد
Lurked = مترصّد
Lurker = لوركير
Lurking = التسنّط
Lurks = يترصّد
Lusaka = لاساكا - عاصمة زامبيا
Luscious = مترف
Lusciously = بشكل مترف
Lusciousness = حلاوة المذاق
Luser = مستخدم الكومبيوتر الغبي
Lush = معشب
Lushes = يسكر
Lushly = بشكل معشب
Lushness = الخضرة
Lust = الرغبة
Lusted = مشتهى
Luster = اللمعان
Lustered = برق - بريق الألماس
Lustering = البريق
Lusters = اللمعان
Lustful = شهواني
Lustfully = بشكل شهواني
Lustfulness = الشهوة
Lustier = أكثر شهوانية
Lustiest = أكثر شهوانية
Lustily = بشهوة
Lustiness = الشهوة
Lusting = الإشتهاء
Lustre = اللمعان
Lustres = اللمعان
Lustrous = لامع
Lustrously = بشكل لامع
Lustrousness = البريق - بريق اﻷلماس
Lusts = الرغبات
Lusty = شهواني
Lutanist = عازف العود
Lute = العود
Luted = مطيّن
Lutes = الأعواد
Lutetium = لوتيتيم - معدن نادر
Luther = لوثر
Lutheran = لوثري
Luting = التطيين
Lutz = لوز
Lux = لاكس
Luxate = إخلع
Luxated = مخلوع
Luxates = يخلع
Luxating = الخلع
Luxe = فخم
Luxembourg = لوكسمبورغ
Luxes = لكس - وحدة قياس شدة الضوء
Luxuriance = الثراء، الوفرة
Luxuriancy = بثراء، بوفرة
Luxuriant = فاخر
Luxuriantly = بشكل مرفّه
Luxuriate = تمتّع
Luxuriated = متمتّع
Luxuriates = يتمتّع
Luxuriating = التمتّع
Luxuries = الرفاهيات
Luxurious = فاخر
Luxuriously = بترف
Luxuriousness = الرفاهية
Luxury = الترف
Luzon = لوزون
Lyceum = صالة حفلات
Lyceums = صالات حفلات
Lycopodium = ليكوبوديوم
Lydia = ليديا
Lye = الغسول
Lying = الكذب
Lyingly = بشكل زائف
Lyings = الكذب
Lykes = ليكيز
Lyle = لايل
Lyman = ليمان
Lymph = اللمف
Lymphatic = ليمفاوي
Lymphatics = ليمفاويين
Lymphocyte = الخلية اللمفية
Lymphocytes = الخلايا اللمفية
Lymphoma = ورم الغدد اللمفاوية
Lynch = أعدم بدون محاكمة
Lynchburg = لنتشبيرغ
Lynched = معدم
Lyncher = منفّذ الإعدام بدون تفويض من المحكمة
Lynches = يعدم
Lynching = القتل
Lyndon = لندون
Lynn = لين
Lynx = الوشق
Lynxes = الوشوق
Lyon = ليون
Lyons = ليون - مدينة في شرق فرنسا
Lyra = ليرا - مجموعة نجوم
Lyre = القيثارة
Lyres = القيثارات
Lyric = القصيدة الغنائية
Lyrical = غنائي
Lyrically = بشكل غنائي
Lyricalness = ليريكالنيس
Lyricism = الإنفعال خلال أداء قطعة فنية
Lyricist = كاتب الأغاني
Lyricists = كتّاب الأغاني
Lyricly = بشكل غنائي
Lyrics = القصائد الغنائية
Lyrist = كاتب الأغاني
Lysenko = ليسينكو
Lysergic = لسيرجيك - مركب عضوي يسبب الهلوسة
Lysine = ليسين - حمض أميني
Listserv = مجمع اوتوماتيكي لتبادل وتوزيع الرّسائل الإلكترونيّة
M = الحرف الثالث عشر في اللغة الإنجليزية
Ma = أمّ
Mabel = مايبيل
Mac = الماك
Macabre = بشع
Macabrely = بشكل بشع
Macadamize = إرصف
Macadamizes = يرصف
Macadamizing = الرصف
Macaque = المكَّاك: قرد آسيويّ
Macaroni = معكرونة
Macaroon = المعكرون: حلوى من بياض البيض وسكّر ولوز
Macaroons = الحلويات
MacArthur = ماكآرثر
Macassar = الاسم القديم لمدينة  Ujung Pandang بإندونيسيا
Macau = ماكو
Macaulay = ماكولاي
Macbeth = ماكبيث
MacDonald = ماكدونالد
MacDougall = ماكدوجال
MacDraw = ماكدراو
Mace = الصولجان
Maced = ماسيد
Macedon = مملكة إغريقية قديمة
Macedonia = مقدونيا
Macedonian = المقدوني
Macer = حامل الصولجان
Macerate = نقّع
Macerated = منقّع
Macerates = ينقّع
Macerating = تنقيع
Maceration = ذبول
Maces = الصولجانات
MacGregor = ماكجريجور
Mach = الماخي
Machete = المنجل
Machiavelli = ميكافيللي
Machiavellians = المنسوبين الى ميكافيللي
Machinable = مفهوم من قبل ألالة
Machinate = تآمر
Machinated = متآمر
Machinates = يتآمر
Machinating = التآمر
Machination = المكيدة
Machinations = مكائد
Machinator = مدبر المكائد
Machine = آلة
Machine-aided = بمساعدة الآلة
Machine-building = بناء الآلة
Machine-code = لغة الآلة
Machine-data = بيانات الآلة
Machine-date = تأريخ الآلة
Machine-dependant = تابع الآلة
Machine-dependent = معتمد على الآلة
Machine-drive = دافع ماكنة
Machine-gun = الرشاشة
Machine-independent = ماكنة مستقلة
Machine-oriented = موجه ماكنة
Machine-tool = الآلة المكنية
Machined = يدار من قبل آلة
Machinelike = كالآلة
Machineries = المكائن
Machinery = المكائن
Machines = المكائن
Machining = استعمال مخرطة أو آلة
Machinist = مشغّل الماكنة
Machinists = مشغلو الماكنة
Machismo = المغالاة بالعضلات
Macho = مفتول العضلات
Macing = المهاجمة بسائل الميس
Macintosh = الماكنتوش
Mack = المشمّع
MacKenzie = ماكينزي
Mackerel = الإسقمري
Mackerels = سمك الأسقمري
Mackey = ماكي
Mackinac = اسم مضيق
Mackinaw = القارب الماكيناويّ
Mackintosh = Mackintosh
Mackintoshs = Mackintoshs
MacMillan = ماكميلان
Macon = ماكون - مدينة في وسط ولاية جورجيا
MacPaint = ماكبينت
Macrame = الرباط الخشن
Macro = ماكرو
Macro-instruction = الأمر الكبير
Macroassembler = المجمع الكبير
Macrobiotic = نباتي
Macrobiotics = نباتي
Macrocosmic = كوني
Macrodynamic = ديناميكا الأجسام الكبيرة
Macroeconomics = الإقتصاد الكلّي
Macromolecular = ضخم الجزيئات
Macromolecule = جزيء ضخم
Macromolecules = جزيئات ضخمة
Macron = علامة المد
Macrons = علامات المدّ
Macrophage = خلية ضخمة مسؤولة عن التنظيف
Macroprocessor = المعالج الكبير
Macros = مختصرات
Macroscopic = عياني
Macroscopically = واضحا للعين
Macrostructure = بنية ترى بالعين المجردة
Maculate = ملوّث
Maculates = يلطّخ
Maculation = تلوث
Mad = مجنون
Mad-doctor = الطبيب المجنون
Madagascar = مدغشقر
Madam = السيدة
Madame = السيدة
Madames = السيدة
Madams = السيدات
Madcab = مادكاب
Madcap = مجنون
Madcaps = الطائشون
Madden = خبّل
Maddend = ماديند
Maddened = مخبّل
Maddening = التخبيل
Maddeningly = بجنون
Maddens = يخبّل
Madder = الفوّة
Maddest = أكثر جنونا
Madding = مسعور
Maddox = مادوكس
Made = جعل
Made-a-call-on = إتّصل على
Made-a-diagnosis = جعل تشخيصا
Made-a-forced-landing = قيم بإنزال إجباري
Made-a-mistake = إرتكب خطأ
Made-a-note-of = كتبت ملاحظة
Made-a-parting = جعل فراق
Made-a-slip = إرتكب خطأ
Made-a-will = جعلت رغبة
Made-amends-for = الإرضاء الصنع لـ
Made-believe = تخيّل
Made-clear = أوضح
Made-desolate = المقفر الصنع
Made-desolated = جعل مقفرا
Made-difficult = جعل صعب
Made-enemies-of = الأعداء الصنع
