Measliness = الصّغر
Measly = تافه
Measurability = القياس
Measurable = قابل للقياس
Measurably = بشكل محسوس
Measure = الإجراء
Measured = مدروس
Measuredly = بشكل مدروس
Measuredness = دراسة
Measurement = المقياس
Measurements = المقاييس
Measurer = كيال
Measures = اجراءات
Measuring = قياس
Measurings = قياس
Meat = لحم
Meatball = ميتبال
Meatier = أكثر لحما
Meatiest = أكثر لحما
Meatiness = كثرة اللحم
Meatless = بلا لحم
Meats = اللحوم
Meaty = لحمي
Mecca = مكة المكرمة
Mechanic = الميكانيكي
Mechanical = ميكانيكي
Mechanically = ميكانيكيا
Mechanicals = ميكانيكي
Mechanician = ميكانيكي
Mechanicians = ميكانيكيون
Mechanics = ميكانيكا
Mechanism = آلية
Mechanisms = آليات
Mechanist = عامل اختصاصي آلات
Mechanistic = ميكانيكي
Mechanistically = ميكانيكي
Mechanists = عمال مختصون بالآلات
Mechanization = المكننة
Mechanizations = المكننة
Mechanize = يمكنن
Mechanized = مجهَّز بالمعدات الميكانيكية
Mechanizer = مُجهِّز بالمعدات الميكانيكية
Mechanizers = مجهِّزوا المعدات الميكانيكية
Mechanizes = يمكنن
Mechanizing = المكننة
Meconium = العِقْي: مادة داكنة تخرج من بطن المولود بُعَيْدَ ولادته
Mecum = ميكم
Med = متوسط
Medal = الوسام
Medaled = أعطي ميدالية
Medaling = اعطاء ميدالية
Medallion = النوط
Medallions = الأنواط
Medals = الأوسمة
Meddle = تدخّل
Meddled = متدخّل
Meddler = متطفّل
Meddles = يتدخّل
Meddlesome = متطفّل
Meddlesomely = بشكل متطفّل
Meddlesomeness = تطفّل
Meddling = تدخّل
Medea = ميديا - أميرة و ساحرة . الأساطير اليونانيّة
Medfield = ميدفيلد
Medford = ميدفورد
Media = أجهزة الإعلام
Mediaeval = من العصور الوسطى
Mediaevally = بشكل من العصور الوسطى
Medial = متوسط
Medially = بشكل إعلامي
Median = متوسط
Medianly = بشكل متوسط
Medians = المتوسطات
Medias = الأوساط
Mediate = توسّط
Mediated = متوسّط
Mediately = بتوسّط
Mediateness = توسّط
Mediates = يتوسّط
Mediating = توسّط
Mediation = وساطة
Mediations = وساطات
Mediative = توسطي
Mediator = وسيط
Mediators = وسطاء
MediaType = نوع الوسيط
Medic = الطبيب
Medicaid = مساعدة طبية
Medical = طبي
Medically = طبيا
Medicament = دواء
Medicare = رعاية طبية
Medicate = عالج
Medicated = معالج
Medicates = يعالج
Medicating = معالجة
Medication = دواء
Medications = أدوية
Medicative = طبّي
Medici = ميديسي
Medicinal = طبي
Medicinally = بشكل طبي
Medicine = طبّ
Medicines = أدوية
Medicis = من عائلة ميديسي الإيطالية
Medico = طبيب
Medicos = أطباء
Medics = أطباء
Medieval = من القرون الوسطى
Medievalism = الإخلاص لمؤسسات القرون الوسطى وفنونها وأعرافها
Medievalist = معجب بتاريخ القرون الوسطى وثقافتها
Medievalists = معجبون بتاريخ القرون الوسطى وثقافتها
Medievally = بشكل من القرون الوسطى
Mediocre = متوسّط
Mediocrities = توسّطات
Mediocrity = توسّط
Meditate = تأمّل
Meditated = متأمّل
Meditates = يتأمّل
Meditating = تأمّل
Meditation = تأمل
Meditations = تأملات
Meditative = متأمّل
Meditatively = بشكل متأمّل
Meditativeness = تأمّل
Mediterranean = البحر الأبيض المتوسط
Medium = متوسط
Mediumistic = روحانيّ
Mediums = متوسطات
Medlar = فاكهة المشملة
Medley = مزيج
Medleys = مزائج
Medly = يخلط
Medulla = النخاع
Medusa = قنديل البحر
Meed = الجائزة
Meek = وديع
Meeker = أحلم
Meekest = أكثر وداعة
Meekly = بشكل وديع
Meekness = حلم
Meet = إجتمع
Meeter = ميتر
Meeting = الإجتماع
Meeting house = مصلّى (عند البروتوستانت خاصة)
Meetings = اجتماعات
Meetly = مناسب، ملائم
Meets = الإجتماعات
Meg = ميج
Mega = هائل
Megabit = مليون رقم ثنائي
Megabits = مليون رقم ثنائي
Megabyte = الميغابايت
Megabytes = الميغابايتات
Megacycle = مليون دورة في الثانية
Megahertz = مليون هرتز في الثانية
Megalomania = جنون العظمة
Megalomaniac = مصاب بجنون العظمة
Megalopolis = مدينة ضخمة
Megalopolises = مدن ضخمة
Megaphone = مكبّر الصوت
Megaton = مليون طنّ
Megatons = مليون طنّ
Megavolt = مليون فولت
Megawatt = ميجاواط
Megaword = مليون كلمة
Megawords = مليون كلمة
Megohm = مليون أوم
Megohms = مليون أوم
Meier = مير
Meiosis = انقسام منصّف
Meister = ميستر
Meistersinger = الموسيقار الكبير
Mekong = ميكونج
Mel = ميل
Melamine = ميلامين
Melancholia = الكآبة
Melancholiac = مصاب بالسوداء
Melancholic = سوداوي
Melancholically = بكئابة
Melancholiness = السوداء
Melancholy = كآبة
Melanesia = جزر ميلانيزيا
Melanesian = ميلانيزيّ
Melange = خليط
Melanie = ميلاني
Melanin = ميلانين
Melanoma = الورم الملاني
Melbourne = ميلبورن
Melcher = ميلتشر
Meld = إخلط
Melded = مخلوط
Melding = الخلط
Melds = يخلط
Melee = المعركة
Melinda = مليندا
Meliorate = حسّن
Meliorated = محسّن
Meliorates = يحسّن
Meliorating = التحسين
Melioration = تحسّن
Meliorations = تحسينات
Meliorative = ينزع إلى التحسّن
Melissa = ميليسا
Mell = يمزج
Mellifluous = سلس
Mellifluously = بشكل سلس
Mellifluousness = سلاسة
Mellon = ميلون - مموّل أمريكيّ و مسئول عامّ
Mellow = ناضج
Mellowed = معتّق
Mellower = أنضج
Mellowest = أنضج
Mellowing = الليونة
Mellowly = بشكل ناضج
Mellowness = اللطافة
Mellows = يلين
Melodic = لحني
Melodically = فيما يتعلق بالنغم
Melodies = الأنغام
Melodious = رخيم
Melodiously = بشكل رخيم
Melodiousness = لحن
Melodrama = ميلودراما
Melodramas = ميلودراما
Melodramatic = ميلودراميّ
Melodramatically = بصورة ميلودراميّة
Melodramatics = سلوك ميلودراميّ (مثير)
Melodramatist = المشارك بالعمل المسرحي المثير
Melody = النغم
Melon = البطيخ
Melons = البطيخ
Melpomene = ربة المأساة عند الإغريق
Melt = ذب
Meltable = قابل للانصهار
Meltdown = الإنهيار
Melted = ذاب
Melter = المتسبب بعملية الذوبان
Melting = الذوبان
Meltingly = بحلاوة
Melts = يذوب
Meltwater = الماء الذائب من جليد أو ثلج
Melville = ميلفيل
Melvin = ميلفن
Member = العضو
Membered = إمتلاك الأطراف
Members = الأعضاء
Membership = العضوية
Memberships = العضويات
Membrane = الغشاء
Membraned = مغطى بغشاء
Membranes = الأغشية
Membranous = غشائي
Memento = تذكار
Mementoes = تذكارات
Mementos = تذكارات
Memo = مذكرة
Memoir = مذكرات
Memoirs = مذكرات
Memorabilia = المخلفّات التذكارية
Memorability = بروز
Memorable = بارز
Memorableness = بروز
Memorably = بشكل بارز
Memoranda = المذكّرات
Memorandum = المذكّرة
Memorandums = المذكّرات
Memorial = الحفل التأبيني
Memorialized = مقدّم مذكرة
Memorially = بشكل تذكاري
Memorials = حفلات تذكارية
Memories = ذكريات
Memorization = استظهار
Memorizations = استظهار
Memorize = استظهر
Memorized = مستظهر
Memorizer = حافظ عن ظهر قلب
Memorizers = حفّاظ عن ظهر قلب
Memorizes = يستظهر
Memorizing = الإستظهار
Memory = الذاكرة
MemorySwapping = الذاكرةالتبديل
Memos = المذكرات
Memphis = ميمفيس
Men = الرجال
Menace = الخطر
Menaced = مهدّد
Menaces = المخاطر
Menacing = التهديد
Menacingly = بشكل مهدّد
Menage = تدبير المنزل
Menagerie = حديقة الحيوان
Menageries = حدائق الحيوان
Menages = تدابير المنزل
Menarche = الحدوث الأول للحيض في إمرأة
Menarches = الحدوث الأول للحيض عند النساء
Mencken = مينكين - محرّر و ناقد أمريكيّ
Mend = الإصلاح
Mendacious = كذّاب
Mendaciously = بشكل كذّاب
