Mira = مستنقع
Miracle = المعجزة
Miracles = المعجزات
Miraculous = أعجوبي
Miraculously = بشكل أعجوبي
Miraculousness = صفة عجيبة
Mirage = السراب
Miraged = سراب
Mirages = طائرات الميراج
Miraging = يتوهم
Miranda = ميراندا
Mire = الطين
Mired = متوحّل
Mires = الأطيان
Miriam = ميريام
Mirier = مرايا
Miriest = الأكثر طيناً
Miring = التوحّل
Mirror = مرآة
Mirrored = انعكس
Mirroring = الإنعكاس
Mirrors = المرايا
Mirth = مرح
Mirthfully = بشكل مرح
Mirthless = مرح قليل
Mirthlessly = بحزن
Mirthlessness = الكآبة
Mirths = الأفراح
Miry = موحل
Misadventure = قضاء وقدر
Misadventures = العوارض
Misalign = اصطفّ خطأ
Misaligned = مصطفّ خطأ
Misaligning = اصطفاف خطأ
Misalignment = اصطفاف خطأ
Misaligns = يصطفّ خطأ
Misanthrope = عدو الإنسان
Misanthropes = أعداء الإنسان
Misanthropic = كاره للبشر
Misanthropically = مبغضًا للبشر
Misanthropist = مبغض للبشر
Misanthropists = مبغضون للبشر
Misanthropy = بغض الجنس البشري
Misapplication = سوء الإستعمال
Misapplied = مساء استعمال
Misapplier = ميسابلير
Misapplies = يسيئ استعمال
Misapply = أسيئ استعمال
Misapplying = إساءة استعمال
Misapprehended = مساء فهم
Misapprehending = اساءة فهم
Misapprehends = يسيء الفهم
Misapprehension = إساءة الفهم
Misapprhend = يسيء الفهم
Misappropriate = اختلس
Misappropriated = مختلس
Misappropriates = يختلس
Misappropriating = اختلاس
Misappropriation = الاختلاس
Misbegotten = نغل
Misbehave = يسيء تصرف
Misbehaved = مساء تصرف
Misbehaver = يسيء التصرف
Misbehaves = يسيئ تصرف
Misbehaving = اساءة تصرف
Misbehavior = سوء السلوك
Misbehaviors = سوء السلوك
Misbelief = رأي خاطئ
Misbeliever = الكافر
Misbrand = يخطئ
Misbranded = أخطأ في وضع العلامة التجارية
Misbranding = يخطئ في وضع العلامة التجارية
Misbrands = يخطئ
Misc = متفرقات
Miscalculate = أخطأ حساب
Miscalculated = أخطئ حساب
Miscalculates = يخطئ حساب
Miscalculating = خطأ حساب
Miscalculation = الخطأ في التّقدير
Miscalculations = الأخطاء في التّقدير
Miscall = أهن
Miscalled = مهان
Miscalling = الإهانة
Miscalls = يهين
Miscarriage = الفشل
Miscarriages = الاخفاقات
Miscarried = مجهض
Miscarries = يجهض
Miscarry = أجهض
Miscarrying = الإجهاض
Miscast = ميسكاست
Miscasting = الخطأ في جمع
Miscasts = ميسكاستس
Miscegenation = تمازج الأجناس
Miscegenations = تمازج الأجناس
Miscellaneous = متنوع
Miscellaneously = بشكل متنوع
Miscellaneousness = حالة متنوعة
Miscellanies = المزيج
Miscellany = مزيج
Mischance = سوء الحظّ
Mischief = الإيذاء
Mischievous = مؤذي
Mischievously = بشكل مؤذي
Mischievousness = وضع مؤذ
Miscibility = القابلية للخلط
Miscible = قابل للاختلاط
Misclassification = سوء فهم
Misclassified = أساء تقسيم
Misclassifying = إساءة تقسيم
Miscode = أخطأ التشفير
Miscommunicate = التخاطب الخاطيء او الغير واضح
Miscommunication = سوء الإتّصالات
Misconceive = أسئ فهم
Misconceived = مساء فهم
Misconceives = يسيئ فهم
Misconceiving = إساءة فهم
Misconception = الوهم
Misconceptions = الأوهام
Misconduct = سوء التصرف
Misconstruction = سوء الفهم
Misconstructions = سوء الفهم
Misconstrue = أسئ فهم
Misconstrued = مساء فهم
Misconstrues = يسيئ فهم
Misconstruing = إساءة فهم
Miscount = الخطأ في العدّ
Miscounted = مخطأ تقدير
Miscounting = خطأ تقدير
Miscounts = الأخطاء في العدّ
Miscreant = الفاجر
Miscreants = الفاجرون
Miscue = أخطأ
Miscues = يخطئ
Misdate = أخطأ تأريخ
Misdated = مخطأ تأريخ
Misdates = يخطئ تأريخ
Misdating = خطأ تأريخ
Misdeed = الإثم
Misdeeds = الآثام
Misdemeanant = المتهم بجنحة
Misdemeanants = المتهم بجنحات
Misdemeanor = الجنحة
Misdemeanors = الجنحة
Misdirect = ضلّل
Misdirected = مضلّل
Misdirecting = التضليل
Misdirection = التضليل
Misdirector = التوجيه الخاطيء
Misdirects = يضلّل
Misdoing = الخطأ
Misentry = معلومة خاطئة
Miser = البخيل
Miserable = بائس
Miserableness = بؤس
Miserably = مثيرا للشفقة
Miseries = التعاسات
Miserliness = بخل
Miserly = بخيل
Misers = بخلاء
Misery = تعاسة
Misfeature = السّمة المريضة
Misfile = أخطأ في حفظ
Misfiled = مخطأ في حفظ
Misfiles = يخطئ في حفظ
Misfiling = خطأ في حفظ
Misfire = خلل الإشعال
Misfired = اختل (السلاح الناريّ)
Misfires = إخفاقات
Misfiring = إخفاق
Misfit = عدم الملائمة
Misfits = عدم الملائمة
Misfortune = سوء الحظ
Misfortunes = سوء الحظ
Misgauge = يقيس شيئ ما بصورة غير صحيحة
Misgauged = قاس شيئ ما بصورة غير صحيحة
Misgauges = يقيس شيئ ما بصورة غير صحيحة
Misgauging = قياس شيئ ما بصورة غير صحيحة
Misgiving = التخوّف
Misgivings = التخوف
Misgovern = أسئ إدارة
Misgoverned = مساء إدارة
Misgoverning = إساءة إدارة
Misgovernment = إساءة الحكم
Misgoverns = يسيئ إدارة
Misguidance = التضليل
Misguide = ضلّل
Misguided = خاطئ
Misguidedly = بطريقة مضلّلة
Misguidedness = التظليل
Misguider = المضلِل
Misguides = يضلّل
Misguiding = التضليل
Mishandle = أسئ استعماله
Mishandled = أساء استعماله
Mishandling = الإساءة استعمال
Mishap = الحادثة
Mishaps = الحوادث
Mishmash = الخليط الغير متجانس
Misidentification = خطأ التّعرّف
Misidentified = أخطأ في التعرف
Misidentifies = يخطئ التّعرّف
Misidentify = يخطيء التّعرّف
Misidentifying = خطأ التّعرّف
Misinform = ضلّل
Misinformation = التضليل
Misinformed = مضلّل
Misinforming = التضليل
Misinforms = يضلّل
Misinterpret = أسئ فهم
Misinterpretation = سوء الفهم
Misinterpretations = سوء الفهم
Misinterpreted = مساء فهم
Misinterpreter = مسيء الفهم
Misinterpreters = مسيؤو الفهم
Misinterpreting = إساءة فهم
Misinterprets = يسيئ فهم
Misjudge = أسئ تقدير
Misjudged = مساء تقدير
Misjudgement = الحكم السيء
Misjudgements = الأحكام السيئة
Misjudges = يسيئ تقدير
Misjudging = إساءة تقدير
Misjudgment = إساءة التقدير
Misjudgments = حالات إساءة التقدير
Mislaid = مفقود
Mislay = إفقد
Mislaying = الفقد
Mislays = يفقد
Mislead = ضلّل
Misleader = المضلّل
Misleading = التضليل
Misleadingly = بشكل مضلّل
Misleads = يضلّل
Misled = ضلّل
Mismanage = أسئ إدارة
Mismanaged = مساء إدارة
Mismanagement = سوء الإدارة
Mismanages = يسيئ إدارة
Mismanaging = إساءة إدارة
Mismatch = اللخبطة
Mismatched = مساء ملائمة
Mismatches = يسيئ ملائمة
Mismatching = إساءة ملائمة
Misname = أسئ تسمية
Misnamed = مساء تسمية
Misnames = يسيئ تسمية
Misnaming = إساءة تسمية
Misnomer = الخطأ في التسمية
Misnomered = سُمِّيَ باسم غير صحيح
Misogamist = كاره الزواج
Misogynist = كاره النساء
Misogynists = كارهو النساء
Misogynous = كاره نساء
Misogyny = كره النساء
Misperceive = أسئ فهم
Misperceived = أساء فهم
Misperceives = يسيئ فهم
Misplace = أخطأ في وضع
Misplaced = في غير مكانها
Misplacement = سوء الوضع
Misplaces = يخطئ في وضع
Misplacing = خطأ في وضع
Misplay = يخطئ في اللعب
Misplayed = أخطأ في اللعب
Misplaying = خطأ في اللعب
Misplays = أخطأ في اللعب
Misprint = خطأ مطبعي
Misprinted = أخطأ في الطبع
Misprinting = خطأ  في الطباعة
Misprints = الأخطاء المطبعية
Mispronounce = أخطأ تلفّظ
Mispronounced = مخطأ تلفّظ
Mispronounces = يخطئ تلفّظ
Mispronouncing = خطأ تلفّظ
Mispronunciation = الخطأ اللفظي
Misquotation = الخطأ في الإقتباس
Misquote = أسئ إقتباس
Misquoted = مساء إقتباس
Misquotes = يسيئ إقتباس
Misquoting = إساءة إقتباس
Misread = أسئ قراءة
Misreader = ميسريدر
Misreading = إساءة قراءة
Misreads = يسيئ قراءة
Misrelated = مساء ربط
Misreporting = خطأ في رواية
Misrepresent = أسئ تمثيل
Misrepresentation = التّحوير في عرض الأمور
Misrepresentations = التّحوير في عرض الأمور
Misrepresentative = تمويهي
Misrepresented = مساء تمثيل
Misrepresenter = المحوّر في عرض الأمور
Misrepresenting = إساءة تمثيل
Misrepresents = يسيئ تمثيل
Misroute = اخطأ توجيه
Misrule = سوء الحكم
Misruled = مساء حكم
Misrules = سوء الأحكام
Misruling = إساءة حكم
