Nay = كلا
Nays = الأصوات المعارضة
Nazarene = الناصري
Nazareth = الناصرة
Nazi = النازي
Nazis = النازيون
Nazism = النازية
NBC = شبكة إن بي سي التلفزيونية
NBS = مكتب المقاييس القوميّ
NC = كارولنا الشماليه
NCAA = الرابطة الوطنية لرياضة الجامعات
NCAR = المركز القوميّ للبحث الجوّيّ
NCC = المجلس الوطني الكنسي
NCO = ضابط الصّفّ
NCR = شركه ان سي ار
ND = داكوتا الشمالية
Ndjamena = نجامينا
Ne = عنصر النيون، ولاية نيبراسكا
Neal = نيل
Neanderthal = الإنسان البدائيّ
Neanderthals = البشر البدائيّون
Neap = المدّ المنخفض
Neapolitan = نابولي
Near = قرب
Nearby = في مكان قريب
Neared = مقترب
Nearer = أقرب
Nearest = أقرب
Nearing = الإقتراب
Nearly = تقريبا
Nearness = القرب
Nears = يقترب منه
Nearsighted = قصير النّظر
Nearsightedly = على نحو قصير النّظر
Nearsightedness = قُصر النّظر
Neat = أنيق
Neaten = يرتّب
Neatened = رتّب
Neatening = الترتيب
Neatens = يرتّب
Neater = أكثر أناقة
Neatest = أكثر أناقة
Neath = تحت
Neatly = بعناية
Neatness = الترتيب
Neats = الأبقار
Nebraska = نبراسكا
Nebraskan = مواطن ولاية نيبراسكا
Nebula = السديم
Nebulae = السدم
Nebular = سديمي
Nebulosity = الضبابية، الغموض
Nebulous = ضبابي
Nebulously = بشكل ضبابي
Nebulousness = الضبابية، الغموض
Necessaries = الضرورات
Necessarily = بالضرورة
Necessary = ضروري
Necessitate = إستلزم
Necessitated = مستوجب
Necessitates = يستوجب
Necessitating = الإستوجاب
Necessitation = الإلزام
Necessities = الضرورات
Necessity = الضرورة
Neck = الرقبة
Neckband = شريط حول ياقة الملابس
Neckbands = أشرطة حول ياقة الملابس
Necked = عانق، قبّل
Necker = نيكر - مموّل فرنسيّ
Neckerchief = منديل حول الرقبة
Neckerchiefs = مناديل حول الرقبة
Necking = التّقبيل، المعانقة
Necklace = القلادة
Necklaces = القلائد
Necklet = العقد
Neckline = خطّ العنق
Necks = الرقاب
Necktie = ربطة العنق
Neckties = ربطات العنق
Necrologies = الوفيّات
Necrology = الوفيّات
Necromancer = مستحضر الأرواح
Necromancers = مستحضر الأرواح
Necromancy = إستحضار الأرواح
Necromantic = بشكل سحري
Necropsy = التّشريح
Necrosis = النخر
Necrotic = نخري
Nectar = السلسبيل
Nectareous = رحيقي
Nectaries = غدد الرحيق في الأزهار
Nectarine = الخوخة
Nectarous = رحيقي
Nectary = غدة الرحيق في الأزهار
Ned = نيد
Nee = بنت
Need = الحاجة
Needed = مطلوب
Needer = المحتاج
Needful = ضروري
Needfully = بشكل ضروري
Needfulness = الحاجة، الضرورة
Needham = نيدام
Needier = أكثر حاجة
Neediest = أكثر حاجة
Needily = باحتياج
Neediness = الفقر
Needing = الإحتياج
Needle = الإبرة
Needled = وخز بإبرة
Needlepoint = التطريز بالإبرة
Needler = المشتغل بالإبر أو بياع الإبر
Needlers = المشتغلون بالإبر أو بياعو الإبر
Needles = الإبر
Needless = غير ضروري
Needlessly = بدون أي داع
Needlessness = الإكتفاء
Needlewoman = الخياطة الماهرة
Needlework = التطريز
Needleworker = خياط الملابس
Needleworks = التطاريز
Needling = الوخز بالإبر
Needly = محتاج
Needs = الحاجات
Needy = محتاج
Nefarious = شنيع
Nefariously = بشكل شنيع
Nefariousness = الشّرّ
Neff = نيف
Negate = إنف
Negated = منفي
Negater = النّافي
Negates = ينفي
Negating = النفي
Negation = الإنكار
Negations = الإنكار
Negative = سلبي
Negatived = رفَضَ
Negatively = سلبيا
Negativeness = الرّفض
Negatives = يرفض
Negativing = يرفض
Negativism = السّلبيّة
Negativisms = السلبيّات
Negativistic = سلبي
Negativity = السلبية
Negator = النّاقض
Negators = النّاقضون
Negerpunk = بونك النيجر
Neglect = الإهمال
Neglected = مهمل
Neglecter = الغير مكترث
Neglectful = مهمل
Neglectfully = بشكل مهمل
Neglectfulness = الإهمال
Neglecting = الإهمال
Neglects = الإهمال
Negligee = الجلباب
Negligees = الجلابيب
Negligence = الإهمال
Negligences = الإهمالات
Negligent = مهمل
Negligently = بشكل مهمل
Negligibility = التّفاهة
Negligible = تافه
Negligibleness = التفاهة
Negligibly = على نحو تافه
Negotiability = قابليّة للتّفاوض
Negotiable = قابل للتفاوض
Negotiant = المفاوض
Negotiate = تفاوض
Negotiated = متفاوض
Negotiates = يتفاوض
Negotiating = التفاوض
Negotiation = المفاوضات
Negotiations = المفاوضات
Negotiator = المفاوض
Negotiators = المفاوضون
Negress = الزنجية
Negresses = الزنجيات
Negro = الزنجي
Negroes = الزنوج
Negroid = زنجيّ
Nehru = نيهرو
Neigh = الصهيل
Neighbor = الجار
Neighbored = مجاور
Neighborhood = الحيّ
Neighborhoods = الأحياء
Neighboring = المجاورة
Neighborliness = حسن الجوار
Neighborly = ودّي
Neighbors = الجيران
Neighborship = الجيرة
Neighbour = الجار
Neighbourhood = الحيّ
Neighbourhoods = الأحياء
Neighbouring = المجاورة
Neighbourly = ودّي
Neighbours = الجيران
Neighed = مصهول
Neighing = الصهيل
Neighs = الصهيل
Neil = نيل
Neither = لا
Neither...nor = لا. . . ولا
Nell = نيل
Nellie = نيلي
Nelsen = نيلسين
Nelson = نيلسن
Nematic = ذو محاور متوازية
Nematode = الدّودة الخيطيّة
Nematodes = الدّيدان الخيطيّة
Nemesis = العدو
Neoclassic = تقليدي حديث
Neoclassical = تقليدي حديث
Neoconservative = المحافظ الجديد
Neocortex = المنطقة الخلفيّة لقشرة المخّ
Neodymium = النيوديميوم - نوع من المعادن
Neolithic = متعلق بالعصر الحجري
Neologism = التعبير الجديد
Neologisms = التعابير الجديدة
Neology = التحديثات اللغوية
Neomycin = النيومايسين - مضادّ حيويّ
Neon = النيون
Neonatal = وليدي
Neonatally = بشكل وليدي
Neonate = الرّضيع
Neoned = معالج بغاز النيون
Neophyte = المبتدىء
Neophytes = المبتدئون
Neoplasm = الورم
Neoplasms = الأورام
Neoprene = النيوبرين - مطّاط صناعيّ
Nepal = النيبال
Nepali = مواطن نيبال
Nepenthe = شراب لنسيان المآسي
Nephew = إبن الأخ
Nephews = أبناء الأخ
Nephritic = الإلتهاب الكلوي
Nepotism = محاباة الأقارب
Nepotistic = محسوبيّ
Neptune = نبتون
Neptunium = النيبتنيوم - عنصر مشعّ
Nerd = الطالب الذي يذاكر كثيرا
Nereid = حوريّة الماء، نيريد أحد أقمار نيبتون
Nero = نيرو
Nerve = العصب
Nerved = شجّع
Nerveless = ضعيف
Nervelessly = بشكل ضعيف
Nervelessness = الضّعف
Nerves = الأعصاب
Nervier = متنرفز
Nerviest = متنرفز
Nerviness = العصبيّة، الجرأة
Nerving = التّشجيع
Nervous = عصبي
Nervously = بشكل عصبي
Nervousness = العصبية
Nervousnesses = العصبية
Nervy = متنرفز
Ness = نيس
Nest = العشّ
Nested = متداخل
Nester = نيستر
Nesting = العشعشة
Nestle = نستلة
Nestled = معشعش
Nestler = نيسلير
Nestles = يعشعش
Nestling = الكتكوت
Nestlings = الكتاكيت
Nestor = نيستر
Nests = الأعشاش
Net = الشبكة
Nether = أسفل
Netherlands = هولندا
Nethermost = أسفل
Netherworld = عالم الأموات
Netraverse = نيترافيرس
Nets = الشبكات
Netscape = النيتسكاب
Netted = مصفّى
Netting = الشبكة
Nettings = الشبكات
Nettle = نبات القراص
Nettled = ملدوغ
Nettles = نباتات القراص
Nettlesome = استفزازيّ
Nettling = اللدغ
Network = الشبكة
Network-dependent = معتمد على شبكة
Network-independent = شبّك مستقل
Network-oriented = موجه شبكة
Network-service = خدمة شبكة
Networked = مشبّك
Networking = ربط الشبكات
Networks = الشبكات
