Nouveau = جديد
Nouvelle = نوفيل
Nov = نوفمبر/تشرين الثّاني
Nova = النّجم
Novak = نوفاك
Novas = النّجوم
Novation = الاستبدال
Novel = الرواية
Novelette = الرواية
Novelist = الروائي
Novelists = الروائيون
Novelized = مقصّص
Novella = الرّواية القصيرة
Novelly = بشكل مبتكر
Novels = الروايات
Novelties = الطرافات
Novelty = الطرافة
November = نوفمبر/تشرين الثّاني
Novembers = أشهر نوفمبر/تشرين الثّاني
Novice = المبتدئ
Novices = المبتدئون
Novitiate = فترة التّدريب
Novo = نوفو
Novosibirsk = نوفوسيبيرسك
Now = الآن
Nowaday = هذه الأيام
Nowadays = في الوقت الحاضر
Noway = نواي
Nowhere = ليس في أي مكان
Nowheres = ولا مكان
Nowhither = بلا إتّجاه
Nowise = ليس بأي شكل
Nows = نوس
Noxious = ضار
Noxiously = بشكل ضار
Noxiousness = الإيذاء
Noyes = نوييز - زعيم دينيّ أمريكيّ
Nozzle = الخرطوم
Nozzles = الخراطيم
NRC = مجلس البحث القوميّ
Nroff = نروف - برنامج تنسيق نصوص
NSF = مؤسّسة العلم القوميّة
Nth = أخير
NTIS = خدمة المعلومات التّقنيّة القوميّة
Nu = نو - الحرف الثّالث عشر للأبجدية اليونانيّة
Nuance = الفرق الدقيق
Nuanced = ملوّن
Nuances = الفروق الدقيقة
Nub = الصميم
Nubia = النّوبة - منطقة صّحراوية و مملكة قديمة
Nubian = النّوبيّ
Nubile = بالغ
Nubs = الألباب
Nuclear = نووي
Nucleate = نووي
Nucleated = متنوّى
Nucleation = الإلتقاء في النواة
Nuclei = النوى
Nucleic = نووي
Nucleole = نواة في داخل نواة
Nucleoli = الأنوية - جمع نواة
Nucleolus = النواة
Nucleon = البروتون أو النيوترون داخل الذرّة
Nucleonics = العلم النّوويّ
Nucleons = النيوترونات او البروتونات
Nucleotide = النكليوتيد
Nucleotides = النكليوتيدات
Nucleus = النواة
Nucleuses = النوى
Nuclide = نوع من الذّرات
Nude = عاري
Nudely = بشكل عاري
Nudeness = التّعرّي
Nuder = عاري
Nudes = العراة
Nudest = عاري
Nudge = الوكزة
Nudged = مدفوع
Nudger = الوخّاز
Nudges = الوكز
Nudging = الدفع
Nudism = العري
Nudist = العاري
Nudists = العراة
Nudity = التعرّي
Nugatory = تافه
Nugent = نجينت
Nugget = الكتلة
Nuggets = الكتل
Nui = الجامعة الوطنية في أيرلندا
Nuisance = مصدر الإزعاج
Nuisances = مصادر الإزعاج
Nuke = السّلاح النّوويّ
Null = ملغي
Nulled = أصبح بلا قيمة
Nullification = الإبطال
Nullified = مبطل
Nullifier = الرّافض، اللاغي
Nullifiers = الرّافضون، اللاغون
Nullifies = يبطل
Nullify = أبطل
Nullifying = الإبطال
Nullities = الباطلون
Nullity = البطلان
Nulls = بلا قيم
Numb = خدران
Numbed = مخدّر
Number = العدد
Numbered = معدود
Numberer = عداد
Numbering = العدّ
Numberless = غير معدود
Numbers = الأعداد
Numbing = التخدير
Numbingly = بتخدير
Numbly = بشكل خدران
Numbness = التّخدّر
Numbs = يخدّر
Numerable = معدود
Numeral = الرقم
Numerally = بشكل رقمي
Numerals = الأرقام
Numerate = جيّد في الحساب
Numerated = محسوب
Numerates = يحسب
Numerating = الحساب
Numeration = العدّ
Numerations = العدّ
Numerative = متعلق بالعد
Numerator = بسط الكسر
Numerators = بسوط الكسر
Numeric = عددي
Numerical = عددي
Numerically = بشكل عددي
Numerics = الأعداد
Numerological = تنجيميّ
Numerology = دراسة الدلالات السحرية للأعداد
Numerous = عديد
Numerously = بكثرة
Numerousness = الكثرة
Numinous = خشوعي
Numismatic = نقودي
Numismatically = متعلق بالعملة
Numismatics = دراسة القطع النقدية والأوسمة
Numismatist = جامع العملات
Nummer = نومير
Numskull = الغبي
Nun = الراهبة
Nunneries = أديرة الراهبات
Nunnery = دير الراهبات
Nuns = الراهبات
Nuptial = الزفاف
Nuptially = بشكل زواجي
Nuptials = الأعراس
Nur = خشب قاسي
Nurse = الممرضة
Nursed = مرعي
Nurseling = الرضيع
Nurselings = الرضّع
Nursemaid = المربية
Nursemaids = المربيات
Nurser = الممرض
Nurseries = رياض الأطفال
Nursery = روضة الأطفال
Nurseryman = صاحب المشتل
Nurses = الممرضات
Nursing = الرعاية
Nursling = الرّضيع
Nurslings = الرّضّع
Nurture = الغذاء
Nurtured = مربّى
Nurturer = الرّاعي
Nurtures = الأغذية
Nurturing = التربية
Nut = البندق
Nutate = أومأ
Nutated = مومأ
Nutates = يأومأ
Nutating = الإيماء
Nutation = الإيماءة
Nutcracker = كسارة البندق
Nutcrackers = كسارات البندق
Nuthatch = نت هاتش - نوع من الطيور
Nutmeg = جوز الطيب
Nutmegs = جوز الطيب
Nutria = الكيب - نوع من القوارض
Nutrient = مغذّي
Nutrients = المواد المغذّية
Nutriment = الغذاء
Nutriments = الأغذية
Nutrition = التغذية
Nutritional = مغذّي
Nutritionally = بشكل مغذّي
Nutritionist = متخصص في التّغذية
Nutritionists = متخصصون في التّغذية
Nutritions = التغذية
Nutritious = مغذّي
Nutritiously = بشكل مغذّي
Nutritiousness = الفائدة الغذائية
Nutritive = مغذّي
Nutritively = بشكل مغذّي
Nuts = البندق
Nutshell = القشر
Nutshells = القشور
Nuttier = أكثر جوزا
Nuttiest = أكثر جوزا
Nuttily = بمسّ من الجنون
Nuttiness = مسّ من الجنون
Nutty = بالبندق
Nuzzle = مرّغ
Nuzzled = ممرّغ
Nuzzles = يمرّغ
Nuzzling = التمريغ
NV = نيفادا
NW = شمال غربي
NY = نيويورك
NYC = مدينة نيويورك
Nylon = النايلون
Nylons = النايلون
Nymph = الحورية
Nymphomania = الشهوة
Nymphomaniac = شبق
Nymphomaniacs = شديدو الشّهوة
Nymphs = الحوريات
NYSE = سوق نيويورك للأوراق المالية
NYU = جامعة نيويورك
Namespace = العالم المجرّد، المجال المجرّد
Nits = الصّؤاب :: القمل الصغير :: بيض القمل
O = أو - الحرف الخامس عشر في اللغة الإنجليزية
O-seal = ألختم المدور
OCR = التّعرّف على الأحرف عن طريق المسح الضّوئي
Oaf = الأحمق
Oafish = أحمق
Oafishly = بوقاحة
Oafishness = بوقاحة
Oafs = الحمقى
Oak = البلوط
Oaken = بلّوطي
Oakland = أوكلند
Oakley = أوكلي
Oakmont = أوكمونت
Oaks = ألبلوط
Oakum = نكيث الأحبال
Oakwood = خشب البلوط
Oar = المجذاف
Oared = مجذوف
Oaring = الجذف
Oarlock = محبس المجداف
Oars = المجاذيف
Oarsman = المجذّف
Oarsmen = المجذّفون
Oases = الواحات
Oasis = الواحة
Oat = الشوفان
Oaten = شوفاني
Oater = فيلم على نمط رعاة البقر
Oath = القسم
Oaths = القسم
Oatmeal = الشوفان المجروش
Oats = الشوفان
Obbligato = اللحن المصاحب
Obduracy = الإصرار
Obdurate = قاسي
Obdurately = بعناد
Obdurateness = القساوه
Obedience = الطاعة
Obediences = الطاعة
Obedient = مطيع
Obediently = بطاعة
Obeisance = السجود
Obeisances = السجود
Obeisant = المطيع
Obeisantly = بانحناء، بطأطأة
Obelisk = المسلّة
Obelisks = المسلات
Oberlin = أوبيرلن
Obese = بدين
Obesity = السمنة
Obey = طع
Obeyed = طعة
Obeyer = مطيع
Obeyes = يطيع
Obeying = الطاعة
Obeys = يطيع
Obfuscate = يشوّش، يجعل الأمر غامض وغير واضح
Obfuscated = مشوّش
Obfuscater = المشوش
Obfuscates = يشوّش
Obfuscating = التشويش
Obfuscation = التشويش
Obfuscations = التشويش
Obfuscatory = إرباكي
Obit = الموت
Obiter = على الطريق
Obituaries = الوفيات
Obituary = النعي
Object = شيئ
Object-lesson = درس الشيئ
Objected = معارض
Objectification = ممثل كشيئ
