Onions = البصل
Onionskin = ورق قوي
Online = على الإنترنت
Onliness = الوُحدة
Onlooker = المشاهد
Onlookers = المشاهدون
Onlooking = متفرّج
Only = فقط
Only...but = فقط. . . لكن
Onomatopoeia = المحاكاة الصوتية
Onomatopoeic = متعلّق بالمحاكاة الصّوتيّة
Onondaga = أونونداجا - شعب أمريكيّ أصليّ
Onrush = التدفق
Onrushes = التدفقات
Onrushing = ريع جدّا
Onscreen = على الشّاشة
Onset = البداية
Onsets = الحملات
Onslaught = الهجوم
Onslaughts = الهجمات
Ontario = أونتاريو
Onto = على
Ontogeny = تطوّر الجنين
Ontological = وجودي
Ontologically = وجوديا
Ontology = علم الوجود
Onus = المسؤولية
Onward = فصاعدا
Onwards = إلى الأمام
Onyx = الجزع
Oocyte = وسيت
Oodles = ودلس
Oops = ويحي
Ooze = الرواسب الطينية
Oozed = نزّ
Oozes = الرواسب الطينية
Oozily = بتدفّق
Ooziness = التدفّق
Oozing = النزيز
Oozy = طينيّ
Op = أضف نمط الإدارة
Opacities = إنعدام الشفافية
Opacity = عدم الشفافية
Opal = العقيق
Opalescence = البريق
Opalescent = برّاق
Opalescently = بشكل برّاق
Opals = الكثافات
Opaque = بليد
Opaquely = بشكل بليد
Opaqueness = انعدام الشّفافيّة
Opcode = عملية برمجية
OPEC = الأوبك
Opel = ماركة سيارات تجارية
Open = مفتوح
Open-minded = منفتح
Opened = مفتوح
Opener = الفتّاحة
Openers = الفتّاحات
Openest = مفتوح
Openhanded = سخيْ
Opening = الإفتتاح
Openings = الإفتتاحيات
Openly = بشكل علني
Openness = الإنفتاح
OpenOffice = أوبن أوفيس
Opens = يفتح
OpenSource = مفتوحة المصدر
Opera = الأوبرا
Operability = القابلية للمعالجة الجراحيّة
Operable = عملي
Operand = من يطبّق عليه العملية الرياضية
Operands = من يطبّق عليهم العملية الرياضية
Operant = فعّال
Operantly = بشكل فعّال
Operants = المؤثّرون
Operas = الأوبرات
Operate = إشتغل
Operated = مشتغل
Operates = يشتغل
Operatic = متعلق بالأوبرا
Operatically = بشكل متعلق بالأوبرا
Operating = التشغيل
Operatingsystem = نظام التشغيل
Operation = العملية
Operational = شغّال
Operationally = بشكل شغّال
Operations = العمليات
Operative = المشارك
Operatively = بفعالية
Operativeness = التجسس
Operatives = المشاركون
Operator = المشغل
Operators = المشغلون
Operculum = الغلاف او الغطاء
Operetta = التمثيلية الموسيقية
Operon = جينات متّصلة مع بعضها
Ophthalmic = بصري
Ophthalmitis = إلتهاب العين، الرّمد
Ophthalmologist = طبيب العيون
Ophthalmology = طبّ العيون
Ophthalmoscope = ناظور العيون
Opiate = الدواء المنوم
Opiates = الأدوية المنومة
Opine = إعتقد
Opined = مقال
Opines = يعتقد
Opining = الإعتقاد
Opinion = الرأي
Opinionate = يعاند
Opinionated = عنيد
Opinionatedly = بعناد
Opinionatedness = العناد
Opinions = الآراء
Opium = الأفيون
Opossum = حيوان الأبوسوم
Oppenheimer = أوبينهايمر - فيزيائيّ أمريكيّ
Opponent = المعارض
Opponents = المعارضون
Opportune = مناسب
Opportunely = بملائمة
Opportunism = الإنتهازية
Opportunisms = الإنتهازية
Opportunistic = إنتهازي
Opportunistically = بانتهازية
Opportunists = الإنتهازيون
Opportunities = الفرص
Opportunity = الفرصة
Opposable = قابل للمعارضة
Oppose = عارض
Opposed = معارض
Opposer = الخصم
Opposes = يعارض
Opposing = المعارضة
Opposite = النظير
Oppositely = بشكل معاكس
Oppositeness = التّضادّ
Opposites = النظراء
Opposition = المعارضة
Oppositional = معارض
Oppositions = المعارضات
Oppress = إضطهد
Oppressed = مضطهد
Oppresses = يضطهد
Oppressing = الإضطهاد
Oppression = الظلم
Oppressions = الجور
Oppressive = مستبدّ
Oppressively = بشكل مستبدّ
Oppressiveness = القسوة
Oppressor = المضطهد
Oppressors = المضطهدون
Opprobrious = مخزي
Opprobriously = بشكل مخزي
Opprobriousness = الوقاحة
Opprobrium = العاري
Opt = إختر
Optative = متمنّي
Opted = مختار
Opthalmic = متعلق بالعين
Optic = بصري
Optical = بصري
Optically = بصريا
Optician = فاحص البصر
Opticians = فاحصو البصر
Optics = البصريات
Optima = الأفضل
Optimal = مثالي
Optimality = الأمثلية
Optimally = بشكل مثالي
Optimism = التفاؤل
Optimist = المتفائل
Optimistic = متفائل
Optimistically = بتفائل
Optimists = المتفائلون
Optimization = تحقيق الأمثلية
Optimizations = تحقيق الأمثلية
Optimize = حسّن
Optimized = محسّن
Optimizer = المحسّن
Optimizes = يحسّن
Optimizing = التحسين
Optimum = الأوج
Opting = الإختيار
Option = الخيار
Optional = إختياري
Optionality = الاختياريّة
Optionally = باختيار
Options = الخيارات
Optoelectronic = الكتروضوئي
Optometric = متعلق بإخصائيّ النّظّارات
Optometrist = إخصائيّ النّظّارات
Optometrists = إخصائيّو النّظّارات
Optometry = فحص النظر
Opts = يختار
Opulence = الثراء
Opulent = غني
Opulently = بشكل غني
Opus = التأليف
Opuses = التأليفات
OR = أو
Oracle = العرّاف :: العرّافة :: إسم تجاري لقاعدة بيانات
Oracles = مهتفو الوحي
Oracular = نبوئي
Oracularly = بشكل نبوئي
Oral = شفهي
Orally = بشكل شفهي
Orals = أورالس
Orange = البرتقال
Orangeade = عصير البرتقال
Orangeroot = أورانجيروت - نبات
Oranges = البرتقال
Orangutan = القرد
Orate = إخطب
Orated = مخطوب
Orates = يخطب
Orating = الخطابة
Oration = الخطاب
Orations = الخطب
Orator = الخطيب
Oratorical = خطابي
Oratorically = بشكل خطابي
Oratories = الخطابات
Oratorio = اللحن الديني
Oratorios = الألحان الدينية
Orators = الخطباء
Oratory = الخطابة
Orb = الجرم السماوي
Orbicular = مستدير
Orbit = المدار
Orbital = مداري
Orbitally = بشكل مداري
Orbitals = المداريّون
Orbited = دير حوله
Orbiter = المتتبّع
Orbiters = المتتبّعات
Orbiting = الإدارة حول
Orbits = المدارات
Orbs = الأجرام السماوية
Orchard = البستان
Orchards = البساتين
Orchestra = الأوركسترا
Orchestral = أوركسترالي
Orchestrally = بشكل أوركسترالي
Orchestras = الأوركسترا
Orchestrate = نظّم
Orchestrated = منظّم
Orchestrater = قائد أوركسترا
Orchestrates = ينظّم
Orchestrating = التنظيم
Orchestration = التوزيع الموسيقي
Orchestrations = التوزيعات الموسيقية
Orchid = السحلب
Orchids = السحالب
Orchis = السحلب
Ordain = مر
Ordained = مقدّر
Ordainer = المستثمر أو الآمر
Ordaining = الأمر
Ordains = يأمر
Ordeal = المحنة
Ordeals = المحن
Order = الطلب
Ordered = منظّم
Orderer = المنظّم
Ordering = الطلب
Orderless = معدوم النظام
Orderlies = الممرضون
Orderliness = التّنظيم
Orderly = بنظام
Orders = الطلبات
Ordinal = العدد الترتيبي
Ordinance = النظام
Ordinances = الأنظمة
Ordinaries = المألوف
Ordinarily = بشكل عادي
Ordinariness = العمومية
Ordinary = عادي
Ordinate = الإحداثي العمودي
Ordinates = الإحداثيات العمودية
Ordination = الرسامة
Ordinations = الرسامات
Ordnance = المدفعية
Ordnances = المدفعيات
Ordure = الغائط
Ore = الخام
Oregano = الأوريجانو - عشبّ
Oregon = أوريغون
Ores = الخامات
Orestes = أوريستيز - ابن أجاميمنون و كليتيمنيسترا . الأساطير اليونانيّة
Organ = العضو
Organdy = الأورجانزا - قماش
Organic = عضوي
Organically = طبيعيا
Organicly = بشكل عضوي
Organics = المواد العضوية
Organisation = المنظمة
Organisations = المنظمات
Organism = الكائن الحي
Organismic = أورجانيسميك
