Overexerted = أتعب
Overexerting = الإنهاك
Overexertion = الإنهاك
Overexerts = ينهك
Overexploitation = فرط الاستغلال
Overexpose = زد في تعريض
Overexposed = مزيد في تعريض
Overexposes = يزيد في تعريض
Overexposing = زيادة في تعريض
Overexposure = التعرّض الشديد
Overexposures = التعرّض الشديد
Overextend = وسّع أكثر من اللازم
Overextended = واسع أكثر من اللازم
Overextending = توسيع أكثر من اللازم
Overextends = يوسّع أكثر من اللازم
Overextension = التوسّع المفرط
Overfall = سطح مضطرب
Overfatigue = الإنهاك
Overfed = إنتخم
Overfeed = أتخم
Overfeeding = الإتخام
Overfeeds = يتخم
Overfill = إملأ
Overfilled = مملوء
Overfilling = الملئ
Overfills = يملأ
Overflew = طير فوقه
Overflies = يطير فوقه
Overflow = الفيض
Overflowed = مفيض
Overflowing = الفيضان
Overflown = حلّق
Overflows = الفيضانات
Overfly = طر فوقه
Overflying = الطيران فوق
Overgenerous = سخي
Overglaze = الطّلاء الفوقيّ
Overgrazing = الرّعي المفرط
Overgrew = زيد في النمو
Overgrow = زد في النمو
Overgrowing = زيادة في النمو
Overgrown = شديد النمو
Overgrows = يزيد في النمو
Overhand = برفع الذّراع
Overhanded = برفع الذّراع
Overhang = الطنف
Overhanging = التدلّي
Overhangs = يتدلّى
Overhappy = مسرور جدا
Overhaste = السرعة المفرطة
Overhasty = سريع جدا
Overhaul = الإصلاح الشامل
Overhauled = مفحوص بدقة
Overhauler = المصلّح
Overhauling = فحص بدقة
Overhauls = الإصلاحات الشاملة
Overhead = فوق
Overheads = النفقات العامة
Overhear = إسمع
Overheard = سمع
Overhearer = مختلس السمع
Overhearing = السمع
Overhears = يسمع
Overheat = إسخن زيادة
Overheated = ساخن زيادة
Overheating = سخونة زيادة
Overheats = يسخن زيادة
Overhung = متدلّى
Overindulged = مفرط في إمتاع
Overindulgence = الإفراط
Overing = للقفز على
Overjoy = أبهج بشدّة
Overjoyed = مغتبط
Overjumps = يقفز
Overkill = الإسراف
Overlaid = غطّى
Overlain = معتلى
Overland = برا
Overlap = التداخل
Overlapped = متداخل
Overlapping = التداخل
Overlaps = التداخلات
Overlay = الغطاء
Overlaying = التغطية
Overlays = الأغطية
Overleaf = على الصفحة الأخرى
Overleap = إقفز
Overleaped = قافز
Overleaping = القفز
Overleaps = يقفز
Overlie = إعتل
Overlies = يعتلي
Overload = الحمل الزائد
Overload-proof = ضدّ الحمل الزائد
Overloaded = أثقل
Overloading = الإثقال
Overloads = الأحمال الزائدة
Overlong = طويل جدا
Overlook = طلّ عليه
Overlooked = مطلول على
Overlooking = الطلّ على
Overlooks = يطلّ عليه
Overlord = السيّد الأعلى
Overlords = السادة الكبار
Overloud = عالي الصوت
Overly = كثيرا
Overlying = الإعتلاء
Overman = المراقب
Overmaster = يتخطى سُلطة المسؤول
Overmastered = تخطى سُلطة المسؤول
Overmastering = تخطي سُلطة المسؤول
Overmasters = يتخطى سُلطة المسؤول
Overmodest = متواضع جدا
Overmuch = أكثر مما يلزم
Overnice = جميل للغاية
Overnight = ليلا
Overnighter = من يعمل شيء طول الليل
Overnighters = من يعملون شيء طول الليل
Overnights = عبر الليالي
Overoptimistic = شديد التفاؤل
Overpaid = زيد دفع
Overpass = إجتز
Overpay = زد دفع
Overpaying = زيادة دفع
Overpayment = الدّفع أكثر مما هو مطلوب
Overpays = يزيد دفع
Overpeopled = مزحم
Overplayed = مبالغ
Overplaying = المبالغة
Overplus = الفائض
Overpopulate = يكدّس الناس
Overpopulated = مزدحم
Overpopulating = تكديس الناس
Overpopulation = الفائض السكاني
Overpopulations = الفائض السكاني
Overpower = إقهر
Overpowered = مقهور
Overpowering = القهر
Overpoweringly = بقوة جبّارة
Overpowers = يقهر
Overpressure = الضغط المفرط
Overprice = زد سعر
Overpriced = مزيد سعر
Overpricing = زيادة سعر
Overprint = زد طبع
Overprinted = مزيد طبع
Overprinting = زيادة طبع
Overprints = يزيد طبع
Overproduce = زد إنتاج
Overproduced = مزيد إنتاج
Overproduces = يزيد إنتاج
Overproducing = زيادة إنتاج
Overproduction = الإفراط في الإنتاج
Overprotection = الحماية المفرطة
Overprotective = من يقوم بعملية الحماية المفرطة
Overqualified = ذو مؤهّلات تزيد عن المطلوب
Overran = إجتح
Overrate = غال في تقييم
Overrated = مغالى في تقييم
Overrates = يغالي في تقييم
Overrating = مغالاة في تقييم
Overreach = تجاوز
Overreached = متجاوز
Overreacher = ذو اليد الطويلة
Overreaches = يتجاوز
Overreaching = التجاوز
Overreact = ردّ بانفعال
Overreacted = ردّ بانفعال
Overreacting = ردّ بانفعال
Overreacts = يردّ بانفعال
Overready = جاهز تماما
Overrepresented = عرضَ بإفراط
Overridden = متجاوز
Override = تجاوز
Overrider = مانع للإصطدام
Overrides = يتجاوز
Overriding = التجاوز
Overripe = ناضج جدا
Overrode = تجاوز
Overrule = إنقض
Overruled = منقوض
Overrules = ينقض
Overruling = النقض
Overrun = التجاوز
Overrunning = الإجتياح
Overruns = التجاوزات
Oversaturate = يشبّع بإفراط
Oversaw = أشرف عليه
Oversea = أوفيرسي
Overseas = في الخارج
Oversee = أشرف عليه
Overseeing = الإشراف على
Overseen = مشرف على
Overseer = المراقب
Overseers = المراقبون
Oversees = يشرف عليه
Oversell = زد مبيعات
Overselling = زيادة مبيعات
Oversells = يزيد مبيعات
Oversensitive = حسّاس جدا
Overshadow = تغلّب عليه
Overshadowed = تغلّب عليه
Overshadowing = التغلّب على
Overshadows = يتغلّب عليه
Overshoe = الجرموق
Overshoes = الجرموق
Overshoot = أوفيرشوت
Overshooting = الذهاب الى ما وراء الهدف
Overshoots = يذهب الى ما وراء الهدف
Overshot = ذهب الى ما وراء الهدف
Oversight = الإشراف
Oversights = الهفوات
Oversimplification = التبسيط المفرط
Oversimplifications = التبسيطات المفرطة
Oversimplified = مبالغ في تبسيط
Oversimplifies = يبالغ في تبسيط
Oversimplify = بالغ في تبسيط
Oversimplifying = مبالغة في تبسيط
Oversize = كبير جدا
Oversized = كبير جدا
Oversizes = المقاسات الكبيرة
Oversleep = أطل النوم
Oversleeping = إطالة النوم
Oversleeps = يطيل النوم
Overslept = أطيل النوم
Oversold = مزيد مبيعات
Overspill = الطفح
Overspray = صبغ ما وراء المنطقة التي يجب صبغها
Overstate = بالغ
Overstated = مبالغ
Overstatement = المغالاة
Overstatements = المغالاة
Overstates = يبالغ
Overstating = المبالغة
Overstay = أطل
Overstayed = طويل
Overstaying = الإطالة
Overstays = يطيل
Overstep = جاوز
Overstepped = مجاوز
Overstepping = المجاوزة
Oversteps = يجاوز
Overstock = خزّن
Overstocked = مخزّن
Overstocking = التخزين
Overstocks = يخزّن
Overstrain = الإرهاق
Overstrained = مرهق
Overstraining = الإرهاق
Overstrains = الإرهاق
Overstress = يشدد بإفراط
Overstretch = أرهق
Overstretched = مرهق
Overstretches = يرهق
Overstretching = الإرهاق
Overstrike = يضرب ويصوب بعيدا
Overstrung = شديد التوتر
Overstuff = حشّ
Overstuffed = محشّى
Overstuffing = التحشية
Overstuffs = يحشّي
Oversubscribe = يطلب أكثر مما هو معروض
Oversubscribed = طلب أكثر مما هو معروض
Oversubscribes = يطلب أكثر مما هو معروض
Oversubscribing = الطّلب أكثر من المعروض
Oversubscription = الطّلب أكثر من المعروض
Oversupplied = زوّد اكثر من الحاجة
Oversupplies = يزوّد اكثر من الحاجة
Oversupply = التزويد اكثر من الحاجة
Oversweet = محلّى بسكّر أكثر من اللازم
Overt = علني
Overtake = إجتز
Overtaken = مجتاز
Overtakes = يجتاز
Overtaking = الإجتياز
Overtax = أرهق بالضرائب
Overtaxed = مرهق بالضرائب
Overtaxes = يرهق بالضرائب
Overtaxing = إرهاق بالضرائب
Overthrew = أسقط
Overthrow = الإسقاط
Overthrowing = الإسقاط
Overthrown = مسقط
Overthrows = الإنقلابات
Overtime = الوقت الإضافي
Overtired = أوفيرتيريد
Overtly = بشكل علني
Overtness = أوفيرتنيس
Overtone = المعنى الإضافي
Overtones = المعاني الإضافية
Overtook = إجتز
Overtopped = ذهب الى ما وراء القمّة
Overtrain = يتدرب بإفراط
Overtrained = تدرّب بإفراط
Overtraining = التدريب بإفراط
Overtrains = يتدرب بإفراط
Overtrump = يلعب الورق
Overtrumped = لعب الورق
Overtrumping = لعب الورق
Overtrumps = يلعب الورق
