Procrastinated = مؤجّل
Procrastinates = يؤجّل
Procrastinating = التأجيل
Procrastination = التأجيل
Procrastinator = المماطل
Procrastinators = المماطلون
Procreate = ولّد
Procreated = مولّد
Procreates = يولّد
Procreating = التوليد
Procreation = الولادة
Procreative = إنجابيّ
Procrustean = إنظباط والتزام من جرّاء التعذيب و القسوة
Procrustes = بروكرستيز - عملاق أسطوريّ. كان لصّ و قاتل . الأساطير اليونانيّة
Procter = بروكتر
Proctological = متعلق في علاج المستقيم و فتحة شرج
Proctologist = أخصّائي الشّرج و المستقيم
Proctology = طب الشّرج و المستقيم
Proctor = المراقب
Proctored = راقب
Proctoring = المراقبة
Proctors = المراقبون
Procurable = يمكن الحصول عليه
Procuration = الحصول على..
Procurator = الوكيل
Procure = حصّل
Procured = محصّل
Procurement = الإقتناء
Procurements = الإقتناء
Procurer = القوّاد
Procurers = القوادون
Procures = يحصّل
Procuring = التحصيل
Procyon = الراكون، النّجم الأكثر إضاءة في الكلب الأصغر
Prod = النخزة
Prodded = محثوث
Prodding = الحثّ
Prodigal = مسرف
Prodigalities = التبذير
Prodigality = الإسراف
Prodigally = بشكل مسرف
Prodigals = المبذرون
Prodigies = المعجزات
Prodigious = ضخم
Prodigiously = بشكل ضخم
Prodigiousness = العظمة
Prodigy = الإعجوبة
Prods = النخز
Produce = المنتج
Produced = منتج
Producer = المنتج
Producers = المنتجون
Produces = المنتجات
Producible = قابل للإنتاج
Producing = الإنتاج
Product = المنتج
Production = الإنتاج
Productions = المنتجات
Productive = منتج
Productively = بوفرة
Productiveness = الإنتاجية
Productivities = معدلات الإنتاج
Productivity = معدل الإنتاج
Products = المنتجات
Proem = التّمهيد
Proems = التّمهيدات
Prof = الأستاذ
Profanation = التدنيس
Profanatory = تدنيسي
Profane = تجديفي
Profaned = مدنّس
Profanely = بشكل تجديفي
Profaneness = الفُسق
Profaner = تجديفي
Profanes = يدنّس
Profaning = التدنيس
Profanity = التجديف
Profess = صرّح
Professed = معترف به
Professedly = علانية
Professes = يصرّح
Professing = التصريح
Profession = المهنة
Professional = المحترف
Professionalism = المهارة
Professionalisms = المهارة
Professionally = بشكل محترف
Professionals = المحترفون
Professions = المهن
Professor = الأستاذ
Professorate = الأستاذيّة
Professorial = أستاذي
Professorially = بشكل أستاذي
Professors = الأساتذة
Professorship = الأستاذية
Proffer = العرض
Proffered = معروض
Proffering = العرض
Proffers = العروض
Proficiencies = المهارات
Proficiency = البراعة
Proficient = ماهر
Proficiently = بشكل ماهر
Profile = لمحة الحياة
Profiled = كتب لمحة عنه
Profiler = المحلّل
Profilers = المحلّلون
Profiles = لمحات الحياة
Profiling = التشخيص
Profit = الربح
Profitability = الربحية
Profitable = مربح
Profitableness = الربحيّة
Profitably = بصورة مربحة
Profited = رابح
Profiteer = الإستغلالي
Profiteering = الإستغلال
Profiteers = الإستغلاليون
Profiting = الربح
Profitless = غير مربح
Profits = الأرباح
Profligacy = الخلاعة
Profligate = الفاسق
Profligately = بشكل مسرف
Profligates = الفاسقون
Profound = عميق
Profoundest = عميق
Profoundly = بشكل كبير
Profoundness = عمق التّفكير
Profundities = الأعماق
Profundity = العمق
Profuse = مسرف
Profusely = باسراف
Profuseness = الوفرة، الغزارة
Profusion = الوفرة
Profusions = الوفرة
Progenies = السلالات
Progenitor = السلف
Progeny = السلالة
Prognoses = التّكهّنات
Prognosis = التشخيص
Prognostic = النذير
Prognosticate = تنبّأ
Prognosticates = يتنبّأ
Prognostication = التكهّن
Prognosticative = تنبؤي
Prognosticator = المتنبّئ
Program = البرنامج
Program-controlled = مدار من قبل البرنامج
Program-sensitive = برمج حسّاس
Programed = مبرمج، برمج
Programing = البرمجة
Programmability = قابليّة البرمجة
Programmable = قابل للبرمجة
Programme = البرنامج
Programmed = مبرمج
Programmer = المبرمج
Programmers = المبرمجون
Programming = البرمجة
Programs = البرامج
Progress = التقدّم
Progressed = متقدّم
Progresses = التقدم
Progressing = التقدّم
Progression = التعاقب
Progressional = متتالي
Progressions = التعاقب
Progressive = تقدمّي
Progressively = تدريجيا
Progressiveness = التّقدّم
Progressivism = التقدمية
Prohibit = إمنع
Prohibited = ممنوع
Prohibiter = المانع
Prohibiting = المنع
Prohibition = المنع
Prohibitions = المنع
Prohibitive = تحريمي
Prohibitively = بشكل محرّم
Prohibitiveness = التعجيزيةّ
Prohibitory = تحريمي
Prohibits = يمنع
Project = المشروع
Projected = متوقّع
Projectile = القذيفة
Projectiles = المقذوفات
Projecting = التسليط
Projection = التقدير
Projectionist = مشغّل ماكينة العرض
Projectionists = مشغّلو ماكينة العرض
Projections = التقديرات
Projective = إسقاطي
Projectively = بشكل إسقاطي
Projector = العارض
Projectors = العارضات
Projects = المشاريع
Prokaryote = بروكاريوت - كائن حي أحاديّ الخليّة
Prokofiev = بروكوفيف - مؤلّف باليه و سيمفونيّات روسيّ
Prolapse = الهبوط
Prolapsed = هابط
Prolapses = الهبوط
Prolapsing = الهبوط
Prolate = متطاول
Prolegomena = المقدّمات
Proletarian = العامل
Proletarianization = عملية الوصول إلى والضع البروليتاريّ
Proletariat = الطبقة العاملة
Proliferate = إنتشر
Proliferated = منتشر
Proliferates = ينتشر
Proliferating = الإنتشار
Proliferation = الإنتشار
Proliferative = متكاثر
Proliferous = متكاثر
Proliferously = بشكل متكاثر
Prolific = منتج
Prolifically = بشكل منتج
Prolificness = الإنتاجية
Proline = البرولين
Prolix = مسهب
Prolixity = الإسهاب
Prolixly = بشكل مسهب
Prolog = برولوج - لغة برمجية
Prologs = يقدّم
Prologue = المقدّمة
Prologues = المقدّمات
Prolong = أطل
Prolongable = قابل للإطالة
Prolongate = أطل
Prolongated = طويل
Prolongates = يطيل
Prolongating = الإطالة
Prolongation = الإطالة
Prolonged = مطوّل
Prolonger = مطول المدّة
Prolonging = الإطالة
Prolongs = يطيل
Prolusion = التّمهيد
Prom = الحفلة الراقصة
Promenade = النزهة
Promenaded = متنزّه
Promenader = الشخص المُتَنزّه
Promenades = النزهة
Promenading = التنزّه
Promethean = مبدع، عمل غير مقتبس
Prometheus = بروميثيوس - العملاق الذي سرق النّيران من أوليمبس و أعطاها للبشريّة. الأساطير اليونانيّة
Promethium = البروميثيوم - عنصر معدنيّ فضّيّ طريّ
Prominence = الأهمية
Prominent = بارز
Prominently = بوضوح
Promiscuity = الإختلاط
Promiscuous = منحلّ، غير أخلاقي
Promiscuously = بإباحة
Promiscuousness = الانحلال
Promise = الوعد
Promised = موعود
Promiser = المتعهّد
Promises = الوعود
Promising = الوعد
Promisingly = بشكل موعود
Promissory = تعهدي
Promontories = النتوءات
Promontory = اللّسان البرّي داخل البحر، صخور بارزة في لبحر
Promotable = قابل للترقية
Promote = روّج له
Promoted = روّج له
Promoter = المروّج
Promoters = المروّجون
Promotes = يروّج له
Promoting = الترويج
Promotion = الترقية
Promotional = ترويجي
Promotions = الترقيات
Promotive = ترويجي
Promotiveness = التشجيعية
Prompt = الأجل
Prompted = مدفوع
Prompter = ملقّن الكلام
Prompters = ملقّنو الكلام
Promptest = واضح، مرئي
Prompting = الدفع
Promptings = التّلقينات
Promptitude = المسارعة
Promptly = فورا
Promptness = المبادرة
Prompts = العلامات
Proms = الحفلات الراقصة
Promulgate = أعلن
Promulgated = معلن
Promulgates = يعلن
Promulgating = الإعلان
Promulgation = النشر
Promulgations = النشر
Prone = منكفئ
Pronely = بشكل منكفئ
Proneness = التّعرّض
Prong = الشعبة
Pronged = متشعّب
Prongs = الشعب
Pronominalize = يعطي صفة الضمير لـ..
