Rebating = الخصم
Rebecca = ريبيكا
Rebel = الثائر
Rebelled = مثار
Rebelling = الثورة
Rebellion = التمرّد
Rebellions = التمرّدات
Rebellious = عاصي
Rebelliously = بشكل عاصي
Rebelliousness = التّمرّد
Rebels = الثوّار
Rebidding = عرض ثانية
Rebids = يعرض ثانية
Rebirth = الإنبعاث
Reblock = إعادة كتلة
Reblocking = إعادة منع
Reboil = أعد غلي
Reboot = إعادة التشغيل
Rebooted = أعيد تشغيل
Rebooting = إعادة تشغيل
Reboots = يعيد تشغيل
Reborn = متجدد
Rebound = العودة إلى الحالة الطبيعية
Rebounded = عاد إلى الحالة الطبيعية
Rebounder = إعادة نصّاب
Rebounding = عودة إلى الحالة الطبيعية
Rebounds = الإرتدادات
Rebroadcast = مذاع ثانية
Rebroadcasting = إعادة إذاعة
Rebroadcasts = يعيد إذاعة..
Rebuff = الرفض
Rebuffed = مرفوض
Rebuffing = الرفض
Rebuffs = الرفض
Rebuild = أعد بناء
Rebuilding = إعادة بناء
Rebuilds = يعيد بناء
Rebuilt = معاد بناء
Rebuke = التوبيخ
Rebuked = موبّخ
Rebuker = الموبّخ
Rebukes = التوبيخ
Rebuking = التوبيخ
Rebukingly = بتوبيخ
Rebus = اللغز
Rebut = إنقض
Rebuts = ينقض
Rebuttal = النقض
Rebuttals = التفنيدات
Rebutted = منقوض
Rebutting = النقض
Rec = سجل
Recalcitrance = الإستعصاء
Recalcitrancy = التّمرّد
Recalcitrant = عنيد
Recalculate = أعد حساب
Recalculated = معاد حساب
Recalculates = يراجع
Recalculating = المراجعة
Recalculation = إعادة حساب
Recalibrate = إعادة تدرّج
Recall = الإستدعاء
Recallable = قابل للتسديد ثانية
Recalled = متذكّر
Recaller = إعادة شخص متّصل
Recalling = التذكير
Recalls = الإستدعاء
Recant = أنكر
Recantation = إقرار الخطأ
Recanted = منكر
Recanting = الإنكار
Recants = ينكر
Recapitalization = إعادة رسملة
Recapitalized = أعيد تمويل
Recapitalizes = يعيد تمويل
Recapitulate = لخّص
Recapitulated = ملخّص
Recapitulates = يلخّص
Recapitulating = التلخيص
Recapitulation = الإعادة المختصرة
Recappable = قابل لمعاودة المعالجة
Recapped = ملخّص
Recapping = إعادة السدّ
Recapture = إستردّ
Recaptured = مستردّ
Recaptures = يستردّ
Recapturing = الإسترداد
Recarbonization = إعادة تفحيم
Recast = إعادة السبك
Recasting = إعادة صياغة
Recasts = يعيد صبّ
Recategorized = مصنّف ثانية
Recd = إعادة قرص مدمج
Recede = إنحسر
Receded = منحسر
Recedes = ينحسر
Receding = الإنحسار
Receipt = الإيصال
Receipted = وقّع إستلام
Receipting = توقيع إستلام
Receipts = الإيصالات
Receivable = قابل للإستلام
Receivables = حسابات المبيعات
Receive = إستلم
Receive-only = إستلم فقط
Receive-site = إستلم موقعا
Received = مستلم
Receiver = المستلم
Receivers = المستلمون
Receivership = التفتيش القضائي
Receives = يستلم
Receiving = الإستلام
Recency = الماضي القريب
Recension = النصّ المنقّح
Recent = أخير
Recently = مؤخرا
Recentness = الماضي القريب
Recentralization = إعادة مركزة
Receptacle = الإناء
Receptacles = الأواني
Receptible = مقبول
Reception = الإستقبال
Receptionist = موظف الإستقبال
Receptionists = موظفو الإستقبال
Receptions = الإستقبالات
Receptive = قابل
Receptively = بشكل قابل
Receptiveness = التقبل
Receptivity = سرعة التلقّن
Receptor = المستقبل
Receptors = المستقبلات
Recertification = إعادة شهادة
Recess = العطلة
Recessed = مثبّت
Recesses = الإستراحة
Recessing = التعطيل
Recession = الكساد
Recessionary = تراجعي
Recessions = الإنحسارات
Recessive = تراجعي
Recessively = بصورة تراجعية
Recessiveness = الرجعية
Recharge = أعد شحن
Recharged = معاد شحن
Recharges = يعيد شحن
Recharging = إعادة شحن
Rechartering = إعادة تأجير
Recheck = أعد فحص
Rechecked = معاد فحص
Rechecking = إعادة فحص
Rechecks = يعيد فحص
Recherche = متكلّف
Rechristen = أعد تعميد
Recidivism = الإرتدائية
Recidivist = المرتكس
Recidivistic = إجراميّ
Recidivous = تراجعي
Recife = ريسيف
Recipe = الوصفة
Recipes = الوصفات
Recipience = القابلية للإستقبال
Recipiency = القابلية للإستقبال
Recipient = المستلم
Recipients = المستلمون
Reciprocal = متبادل
Reciprocality = العلاقة المتبادلة
Reciprocally = بشكل متبادل
Reciprocals = المتبادلات
Reciprocate = بادل
Reciprocated = مبادل
Reciprocates = يبادل
Reciprocating = المبادلة
Reciprocation = التبادل
Reciprocative = تبادلي
Reciprocity = التبادل
Recirculate = أعد توزيع
Recirculated = معاد توزيع
Recirculates = يعيد توزيع
Recirculating = إعادة توزيع
Recirculation = إعادة توزيع
Recital = الرواية
Recitals = الروايات
Recitation = التسميع
Recitations = التسميع
Recitative = الخطبة المنغّمة
Recite = إقرأ
Recited = مقروء
Reciter = القارئ
Reciters = القرّاء
Recites = يقرأ
Reciting = القراءة
Recivilization = إعادة حضارة
Recivilizes = يمدّن ثانية
Reck = إرع
Reckless = متهوّر
Recklessly = بشكل متهوّر
Recklessness = التهوّر
Reckon = إحسب
Reckoned = محسوب
Reckoner = الحاسب
Reckoners = الحاسبون
Reckoning = الحساب
Reckonings = الحساب
Reckons = يحسب
Reclaim = إستردّ
Reclaimable = قابل للإسترداد
Reclaimed = مستردّ
Reclaimer = إعادة طالب
Reclaiming = الإسترداد
Reclaims = يستردّ
Reclamation = الإستصلاح
Reclamations = الإستصلاح
Reclassification = إعادة تصنيف
Reclassified = معاد تصنيف
Reclassifies = يعيد تصنيف
Reclassify = أعد تصنيف
Reclassifying = إعادة تصنيف
Recline = إتّكأ
Reclined = متّكأ
Recliner = كرسي
Reclines = يتّكئ
Reclining = الإتّكاء
Reclothe = ألبس ثانية
Reclothed = ملبس ثانية
Reclothes = يلبس ثانية
Reclothing = إلباس ثانية
Recluse = منعزل
Recluses = المعتكفون
Reclusion = التّنسّك، الإنعزال عن العالم
Reclusive = منعزل
Reclusively = بشكل منعزل
Reclusiveness = الإنطوائيّة
Reclustered = متجمّع ثانية
Recode = إعادة رمز
Recoded = مشفّر ثانية
Recodes = ريكودز
Recoding = إعادة تشفير
Recognition = الإعتراف
Recognitions = التمييز
Recognizability = القدرة على التمييز
Recognizable = سهل التمييز
Recognizably = بشكل قابل للتمييز
Recognizance = التعهّد
Recognize = إعترف
Recognized = معترف به
Recognizedly = بشكل معترف به
Recognizer = المتعرّف على..
Recognizes = يعترف
Recognizing = الإعتراف
Recoil = الإرتداد
Recoiled = مرتدّ
Recoiling = الإرتداد
Recoilless = قليل الارتداد
Recoils = الإرتداد
Recoin = جدّد سكّ
Recoinage = إعادة عملة
Recoined = مجدّد سكّ
Recoining = تجديد سكّ
Recoins = يجدّد سكّ
Recollect = تذكّر
Recollected = متذكّر
Recollecting = التذكير
Recollection = التذكّر
Recollections = التذكّر
Recollective = جماعي ثانية
Recollectively = إعادة بشكل جماعي
Recollects = يتذكّر
Recolonization = إعادة إستعمار
Recolonize = أعد إستعمار
Recolonizes = يعيد إستعمار
Recolor = أعد تلوين
Recolored = معاد تلوين
Recoloring = إعادة تلوين
Recolors = يعيد تلوين
Recombinant = محصّلة التّهجين
Recombination = التّهجين
Recombinational = تهجيني
Recombine = أعد توحيد
Recombined = معاد توحيد
Recombines = يعيد توحيد
Recombining = إعادة توحيد
Recommence = إبدأ
Recommenced = بدأ
Recommencement = إعادة بدء
Recommences = يبدأ
Recommencing = البدء
Recommend = أوص به
Recommendable = موصى به
Recommendation = التوصية
Recommendations = التوصيات
Recommendatory = مديحي ثانية
Recommended = موصّى به
Recommender = المزكّي
Recommending = التوصية
Recommends = يوصي به
Recommission = أعد تكليف
Recommissioned = معاد تكليف
Recommissioning = إعادة تكليف
Recommissions = يعيد تكليف
Recommit = إقترف ثانية
