Recommits = يقترف ثانية
Recommittal = إعادة إحالة
Recommitted = مقترف ثانية
Recommitting = إقتراف ثانية
Recompense = المكافأة
Recompensed = معوّض
Recompenses = المكافآت
Recompensing = التعويض
Recompile = أعد تجميع
Recompiled = معاد تجميع
Recompiles = يعيد تجميع
Recompiling = إعادة تجميع
Recomplement = إعادة تكملة
Recomplementing = إعادة تتميم
Recompose = أعد تجميع
Recomposed = معاد تجميع
Recomposes = يعيد تجميع
Recomposing = إعادة تأليف
Recomposition = إعادة تركيب
Recompute = إعادة تحسب
Recomputed = محسوب ثانية
Recomputing = إعادة إستعمال حاسبات
Reconceptualization = إعادة وضع المفاهيم
Reconceptualizing = إعادة وضع المفاهيم
Reconcilable = قابل للتسوية
Reconcilableness = القابلية للتسوية
Reconcilably = بشكل يقبل التسوية
Reconcile = صالح
Reconciled = مصالح
Reconciler = المصلح
Reconciles = يصالح
Reconciliation = المصالحة
Reconciliations = المصالحة
Reconciliatory = تصالحي
Reconciling = المصالحة
Recondite = مبهم
Reconditely = بشكل مبهم
Reconditeness = الغموض
Recondition = جدّد
Reconditioned = مجدّد
Reconditioning = التجديد
Reconditions = يجدّد
Reconfigurate = إعادة تشكّل
Reconfiguration = إعادة ترتيب
Reconfigure = إعادة تشكّل
Reconfigured = مشكّل ثانية
Reconfigures = يعيد تشكيل
Reconfiguring = إعادة تشكيل
Reconfirm = جدّد تأكيد
Reconfirmation = إعادة تأكيد
Reconfirmed = مجدّد تأكيد
Reconfirming = تجديد تأكيد
Reconfirms = يجدّد تأكيد
Reconnaissance = الإستطلاع
Reconnaissances = الإستكشافات
Reconnect = أعد ربط
Reconnected = معاد الربط
Reconnecter = إعادة موصّل
Reconnecting = إعادة ربط
Reconnection = إعادة إتّصال
Reconnects = يعيد ربط
Reconnoiter = يستطلع
Reconnoitered = إستطلع
Reconnoitering = الإستطلاع
Reconnoiters = يستطلع
Reconnoitre = إستكشف
Reconnoitred = مستكشف
Reconnoitres = يستكشف
Reconnoitring = الإستكشاف
Reconquer = أعد إحتلال
Reconquered = معاد إحتلال
Reconquering = إعادة إحتلال
Reconquers = يعيد إحتلال
Reconsider = أعد النظر فيه
Reconsideration = إعادة النظر
Reconsidered = أعيد النظر فيه
Reconsidering = الإعادة النظر في
Reconsiders = يعيد النظر فيه
Reconsolidated = مجدّد تعزيز
Reconsolidates = يجدّد تعزيز
Reconstituted = معاد تكوين
Reconstitutes = يعيد تكوين
Reconstitution = إعادة دستور
Reconstruct = أعد بناء
Reconstructed = معاد بناء
Reconstructible = قابل لإعادة البناء
Reconstructing = إعادة بناء
Reconstruction = إعادة البناء
Reconstructions = إعادة البناء
Reconstructive = بنّاء ثانية
Reconstructs = يعيد بناء
Recontacted = متّصل بثانية
Recontaminate = أعد تلويث
Recontaminated = معاد تلويث
Recontaminates = يعيد تلويث
Recontaminating = إعادة تلويث
Recontamination = إعادة تلوّث
Recontrol = إعادة سيطرة
Reconvene = إجتمع مجدّدا
Reconvened = إجتمع مجدّدا
Reconvenes = يجتمع مجدّدا
Reconvening = إجتماع مجدّدا
Reconvention = إعادة إتفاقية
Reconversion = إعادة تحويل
Reconvert = أعد
Reconverted = معاد
Reconverting = الإعادة
Reconverts = يعيد
Recopied = منسوخ ثانية
Recopy = إعادة نسخة
Recopying = ناسخ ثانية
Record = السجلّ
Record-by-record = سجلّ بالسجلّ
Recordable = قابل للتسجيل
Recorded = مسجّل
Recorder = المسجّلة
Recorders = المسجّلات
Recording = التسجيل
Recordings = التسجيلات
Records = السجلات
Recored = محفور ثانية
Recount = إعادة العدّ
Recounted = معاد حساب
Recounter = مضاد ثانية
Recounting = إعادة حساب
Recounts = إعادة العدّ
Recoup = إسترجع
Recouped = مسترجع
Recouping = الإسترجاع
Recoupment = التعويض
Recoups = يسترجع
Recourse = الإستعانة
Recourses = يعود
Recover = تعاف
Recoverability = القابليّة للشّفاء
Recoverable = قابل للإسترداد
Recovered = تعافى
Recoverer = المنقذ
Recoveries = المعافاة
Recovering = التعافي
Recovers = يتعافى
Recovery = التحسّن
Recreance = النذالة
Recreancy = النذالة
Recreant = النّذل
Recreate = أعد تكوين
Recreated = أعيد تكوين
Recreates = يعيد تكوين
Recreating = إعادة تكوين
Recreation = الإستجمام
Recreational = ترفيهي
Recreations = الإستجمام
Recreative = منعش
Recriminate = ردّ
Recriminated = مردود
Recriminates = يردّ
Recriminating = الردّ
Recrimination = الإتهام المضاد
Recriminations = الإتهامات المضادة
Recriminative = تجريمي ثانية
Recriminatory = تجريمي ثانية
Recrudesce = عد
Recrudesced = عاد
Recrudescent = متجدّد
Recrudesces = يعود
Recrudescing = العودة
Recruit = المجنّد
Recruited = مجنّد
Recruiter = المشغّل
Recruiters = المشغّلون
Recruiting = التجنيد
Recruitment = الإستخدام
Recruits = المجنّدون
Recrystallization = إعادة بلورة
Recrystallize = أعد بلورة
Recrystallized = معاد بلورة
Recrystallizes = يعيد بلورة
Recrystallizing = إعادة بلورة
Recta = المستقيمات
Rectal = مستقيمي
Rectally = بشكل مستقيمي
Rectangle = المستطيل
Rectangles = المستطيلات
Rectangular = مستطيل
Rectangularly = بشكل مستطيل
Rectifiable = قابل للإصلاح
Rectification = التصحيح
Rectifications = التصحيح
Rectified = مصحّح
Rectifier = المعدل
Rectifiers = المعدلات
Rectifies = يصحّح
Rectify = صحّح
Rectifying = التصحيح
Rectilinear = مستقيم
Rectilinearly = بشكل مستقيم
Rectitude = الإستقامة
Rector = الخوري
Rectorate = منصب القسّيس
Rectories = بيوت القساوسة
Rectors = الخوريون
Rectory = منزل كاهن الأبرشية
Rectum = المستقيم
Rectums = المستقيم
Recumbency = الاستلقاء
Recumbent = مستلقي
Recumbently = بشكل مستلقي
Recuperate = تعاف
Recuperated = متعافى
Recuperates = يتعافى
Recuperating = التعافي
Recuperation = التعافي
Recuperative = مسترد
Recur = إرجع
Recurred = راجع
Recurrence = التكرار
Recurrences = التكرارات
Recurrent = متكرّر
Recurrently = بشكل متكرّر
Recurring = الرجوع
Recurs = يرجع
Recurse = إعادة لعنة
Recursed = ملعون ثانية
Recursing = إعادة لعنة
Recursion = استدعاء ذاتي
Recursive = تكراري
Recursively = بشكل تكراري
Recursiveness = التكراريّة
Recurved = منحنى
Recusant = المتمرّد
Recuse = أعلن عدم أهلية
Recyclable = ممكن معالجته واستعماله مرة اخرى
Recycle = أعد
Recycled = معاد
Recycles = يعيد
Recycling = الإعادة
Red = أحمر
Redact = نقّح
Redacted = منقّح
Redacting = التنقيح
Redaction = التّنقيح
Redactor = المحرّر
Redacts = ينقّح
Redbird = ريدبيرد - نوع من الطيور
Redbirds = ريدبيرد - نوع من الطيور
Redbreast = أبو الحناء
Redbreasts = آباء الحناء
Redbud = ريدبد - شجرة
Redcoat = الجنديّ البريطانيّ
Redcoats = الجنود البريطانيّون
Redden = حمّر
Reddened = محمّر
Reddening = التحمير
Reddens = يحمّر
Redder = أشدّ إحمرارا
Reddest = أشدّ إحمرارا
Redding = التوضيح
Reddish = المحمّر
Reddishly = بشكل محمّر
Reddishness = الإحمرار
Redeclare = إعادة تعلن
Redeclared = معلن ثانية
Redeclares = ريديكليرس
Redeclaring = إعادة إعلان
Redecorate = جدّد
Redecorated = مجدّد
Redecorates = يجدّد
Redecorating = التجديد
Redecoration = إعادة زينة
Rededicate = أهد ثانية
Redeem = خلّص
Redeemable = قابل للإسترداد
Redeemed = معوّض
Redeemer = المخلّص
Redeemers = المخلّصون
Redeeming = التعويض
Redeems = يعوّض
Redefine = أعد تعريف
Redefined = معاد تعريف
Redefines = يعيد تعريف
Redefining = إعادة تعريف
Redefinition = إعادة تعريف
Redeliver = أعد
Redelivered = معاد
Redelivering = الإعادة
Redelivers = يعيد
Redemand = إطلب ثانية
Redemanded = مطلوب ثانية
Redemanding = طلب ثانية
Redemands = يطلب ثانية
Redemption = التسديد
Redemptioner = المتحرر من الدّيون
Redemptions = التسديد
Redemptive = تعويضي
Redemptory = تحرّري
Reden = إعادة عرين
Redeploy = أعد ترتيب
Redeployed = معاد ترتيب
Redeploying = إعادة ترتيب
Redeployment = إعادة إنتشار
