Reloads = يعيد تحميل
Reloan = إعادة قرض
Relocatable = ممكن تغيير مكانه
Relocate = إنتقل
Relocated = منتقل
Relocates = ينتقل
Relocating = الإنتقال
Relocation = الإنتقال
Relocations = الإنتقال
Reluctance = التردّد
Reluctances = الإحجام
Reluctancy = المعارضة
Reluctant = ممانع
Reluctantly = بتردّد
Relucting = التردّد
Rely = إعتمد
Relying = الإعتماد
Remade = الصنع ثانية
Remagnify = إعادة تكبّر
Remain = إبق
Remainder = البقيّة
Remaindered = تبقّى
Remaindering = التّبقّي
Remainders = البقايا
Remained = باق
Remaining = البقاء
Remains = البقايا
Remake = أعد صنع
Remakes = يعيد صنع
Remaking = إعادة صنع
Reman = أعد تجهيز
Remand = إعادة الدعوة
Remanded = محجوز
Remanding = الحجز
Remanence = المغناطيسية
Remanent = المتبقّي
Remark = الملاحظة
Remarkable = رائع
Remarkableness = الرّوعة
Remarkably = على نحو رائع
Remarked = مشار
Remarking = الإشارة
Remarks = الملاحظات
Remarriage = إعادة زواج
Remarried = متزوّج ثانية
Remarries = يتزوّج ثانية
Remarry = تزوّج ثانية
Remarrying = زواج ثانية
Rematch = إعادة مباراة
Rembrandt = ريمبراندت
Remeasure = أعد قياس
Remeasured = معاد قياس
Remeasures = يعيد قياس
Remeasuring = إعادة قياس
Remediable = قابل للإصلاح
Remediableness = القابلة للإصلاح
Remediably = بطريقة إصلاحية
Remedial = علاجي
Remedially = بشكل علاجي
Remedied = معالج
Remedies = العلاج
Remedy = العلاج
Remedying = المعالجة
Remelt = ذب ثانية
Remelted = مذاب ثانية
Remelting = ذوبان ثانية
Remelts = يذوب ثانية
Remember = تذكّر
Rememberable = ممكن إسترجاعه من الذاكرة
Remembered = متذكّر
Rememberer = المتذكّر
Remembering = التذكير
Remembers = يتذكّر
Remembrance = الذكرى
Remembrancer = المُذكّر
Remembrances = التذكر
Remigrate = هاجر ثانية
Remigration = إعادة هجرة
Remind = ذكّر
Reminded = مذكّر
Reminder = رسالة التذكير
Reminders = رسائل التذكير
Reminding = التذكير
Reminds = يذكّر
Remington = ريمنجتن
Reminisce = تذكّر
Reminisced = متذكّر
Reminiscence = ذكريات الماضي
Reminiscences = الذّكريات
Reminiscent = تذكري
Reminiscential = متعلق بالذّكرى
Reminiscently = بشكل تذكري
Reminisces = يتذكّر
Reminiscing = التذكير
Remiss = مهمل
Remissible = ممكن مغفرته
Remission = المغفرة
Remissions = المغفرة
Remissly = بشكل مهمل
Remissness = الإهمال
Remit = المسؤولية
Remits = المسؤوليات
Remittal = الغفران
Remittance = الحوالة المالية
Remittances = الحوالات المالية
Remitted = معاد
Remittee = المستفيد من الحوالة المالية
Remittent = متقطّع
Remittently = بشكل متقطّع
Remitter = باعث الحوالة المالية
Remitting = الإعادة
Remix = عدّل
Remixed = معدّل
Remixes = يعدّل
Remixing = التعديل
Remnant = البقية
Remnants = البقايا
Remobilization = إعادة تعبئة
Remodel = أعد تشكيل
Remodeled = مشكّل ثانية
Remodeling = إعادة عرض
Remodelled = معاد تشكيل
Remodelling = إعادة تشكيل
Remodels = يعيد تشكيل
Remodulate = إعادة تنظّم
Remodulated = منظّم ثانية
Remodulating = إعادة تنظيم
Remodulation = إعادة تحوير
Remolding = إعادة صبّ
Remonetization = إعادة إستعمال المعدن
Remonetize = إعادة تنقّد
Remonetized = منقّد ثانية
Remonetizes = يجيز كعملة
Remonetizing = إعادة تنقيد
Remonstrance = الإحتجاج
Remonstrant = محتج
Remonstrate = إحتجّ
Remonstrated = محتجّ
Remonstrates = يحتجّ
Remonstrating = الإحتجاج
Remonstration = الاحتجاج
Remonstrative = إعتراضي
Remonstratively = بشكل إعتراضي
Remorse = الندم
Remorseful = نادم
Remorsefully = بندم
Remorsefulness = الندم
Remorseless = قاسي
Remorselessly = بشكل قاسي
Remorselessness = القسوة
Remorses = الندم
Remote = بعيد
Remote-controlled = بعيد التحكّم
Remotely = عن بعد
Remoteness = البعد
Remotenesses = البعد
Remotest = أبعد
Remotion = إعادة حركة
Remoulds = الدواليب المجددة
Remount = الفرس البديل
Remounted = معتلى ثانية
Remounting = إعتلاء ثانية
Remounts = الحصن البديلة
Removable = قابل للفصل
Removableness = القابلية للإزالة
Removal = الإزالة
Removals = الإزالات
Remove = الخطوة
Removed = مزال
Remover = المزيل
Removers = المزيلات
Removes = يزيل
Removing = الإزالة
Remunerable = يستحق المكافئة
Remunerate = كافئ
Remunerated = مكافأ
Remunerates = يكافئ
Remunerating = المكافئة
Remuneration = المكافأة
Remunerations = المكافآت
Remunerative = مدفوع الأجر
Remuneratively = بشكل مدفوع الأجر
Remunerativeness = الربحية
Remus = ريمس - الأخ التوأم لروملس . الأساطير الرّومانيّة
Rena = رينا
Renaissance = عصر النهضة
Renal = كلوي
Rename = بدّل إسم
Renamed = مبدّل إسم
Renames = يبدّل إسم
Renaming = تبديل إسم
Renascence = النهضة
Renascent = ناشئ ثانية
Renaturation = الإعادة الى الوضع السابق
Renature = إعادة طبيعة
Renatured = أعاده الى طبيعته
Renatures = يعيده الى طبيعته
Renaturing = العوده الى الحالة الأصلية
Renault = رينو
Rend = مزّق
Rended = مزّق
Render = أعد
Rendered = معاد
Renderer = جاعل الشيء
Rendering = الجعل
Renderings = الأداءات
Renders = يعيد
Rendezvous = الملتقى
Rendezvoused = تواعد
Rendezvouses = الملتقيات
Rendezvousing = التواعد
Rending = التمزيق
Rendition = الأداء
Renditions = الأداء
Rends = يمزّق
Rene = رينيه
Renee = ريني
Renegade = المتمرّد
Renegades = المرتدّون
Renege = إنكث العهد
Reneged = نكث العهد
Reneges = ينكث العهد
Reneging = نكث العهد
Renegotiable = قابل للتفاوض ثانية
Renegotiate = أعد بحث
Renegotiated = أعيد بحث
Renegotiates = يعيد بحث
Renegotiating = إعادة بحث
Renegotiation = إعادة مفاوضات
Renew = جدّد
Renewable = المتجدّد
Renewal = التجديد
Renewals = التجديد
Renewed = مجدّد
Renewer = أحدث ثانية
Renewing = التجديد
Renews = يجدّد
Rennet = المنفحة
Reno = رينو
Renoir = رينوا
Renominate = أعد ترشيح
Renominated = معاد ترشيح
Renominates = يعيد ترشيح
Renominating = إعادة ترشيح
Renomination = إعادة ترشيح
Renormalized = مطبّع ثانية
Renormalizes = يعيد الشيء الى حالة متّفق عليها ومقبولة
Renounce = إترك
Renounced = متروك
Renouncer = الهاجر
Renounces = يترك
Renouncing = الترك
Renovate = رمّم
Renovated = رمّم
Renovates = يرمّم
Renovating = الترميم
Renovation = الترميم
Renovator = المرمم
Renown = الصيت
Renowned = مشهور
Renownedly = بشكل مشهور
Rensselaer = رينسيلار
Rent = الإيجار
Rental = التأجير
Rentals = الإيجارات
Rented = مستأجر
Renter = رف
Renters = يروف
Renting = التأجير
Rents = الإيجارات
Renumber = أعد ترقيم
Renumbered = معاد ترقيم
Renumbering = إعادة ترقيم
Renumbers = يعيد ترقيم
Renunciation = التنازل
Renunciations = التنازلات
Renunciative = تنازلي
Renunciatory = متعلق بالتنازل
Renville = رينفيل
Reobtain = إستعد
Reobtained = مستعاد
Reobtaining = الإستعادة
Reobtains = يستعيد
Reoccupation = إعادة الإحتلال
Reoccupied = محتلّ ثانية
Reoccupies = يحتلّ ثانية
Reoccupy = إحتلّ ثانية
Reoccupying = إحتلال ثانية
Reoccur = إعادة تحدث
Reoccurred = حادث ثانية
Reoccurrence = إعادة حدوث
Reoccurring = إعادة حدث
Reoccurs = يحدث مجدّدًا
Reopen = أعد فتح
Reopened = معاد فتح
Reopening = إعادة فتح
Reopens = يعيد فتح
Reoppose = إعادة تعارض
Reorder = إطلب ثانية
Reorderable = قابل لإعادة الترتيب
