Sale = البيع
Saleable = قابل للبيع
Salem = سالم
Salerno = ساليرنو
Sales = المبيعات
Sales tax = ضريبة المبيعات
Salesclerk = كاتب المبيعات
Salesgirl = البائعة
Salesian = ساليسايان - عضو في جمعية فرنسيس القدّيس
Salesladies = البائعات
Saleslady = البائعة
Salesman = البائع
Salesmanship = فن البيع
Salesmen = الباعة
Salespeople = الباعة
Salesperson = البائع
Salesroom = صالة العرض بهدف البيع
Saleswoman = البائعة
Saleswomen = البائعات
Salicylic = حمض ساليسيليكي
Salience = الأهمّيّة
Saliency = الأهمّيّة
Salient = النتوء
Saliently = بشكل بارز
Salina = سالينا
Saline = الملح
Salinger = سالينجير
Salinity = الملوحة
Salisbury = ساليسبري
Salish = سال تقريبا
Saliva = اللعاب
Salivary = لعابي
Salivate = روّل
Salivated = مروّل
Salivates = يروّل
Salivating = الترويل
Salivation = سيلان اللعاب
Salk = سالك
Salle = سال
Sallied = اندفع
Sallies = الإندفاعات
Sallow = شاحب
Sallowness = الشّحوب
Sally = سالي
Sallying = الاندفاع
Salmon = السلمون
Salmonberry = التّوت
Salmonella = السالمونيلا
Salmons = السلمون
Salon = الصالون
Salons = الصالونات
Saloon = الصالون
Saloonkeeper = مالك الحانة
Saloons = الصالونات
Salsa = الصلصا
Salsas = الصلصا
Salsifies = سالسيفي - نبات
Salsify = سالسيفي - نبات
Salt = الصلت
Saltbush = سالتبش - نبات
Salted = مملّح
Salter = تاجر الملح
Salters = تجّار الملح
Saltier = أملح
Saltiest = أملح
Saltily = مالحا
Saltiness = الملوحة
Salting = التمليح
Saltless = بدون ملح
Saltness = الملوحة
Saltpeter = نترات البوتاسيوم - سماد
Salts = الأملاح
Saltshaker = المملحة
Saltus = التّأرجح
Saltwater = الماء المالح
Salty = مالح
Salubrious = صحي
Salubriously = بشكل صحي
Salubriousness = الصّحية
Salubrity = المحافظة على الصحة
Salutarily = ترحيبيا
Salutariness = الصّحية
Salutary = مفيد
Salutation = التحيّة
Salutations = التحيّات
Salutatory = ترحيبي
Salute = التحية
Saluted = محيّا
Saluter = سالوتر
Salutes = التحيات
Saluting = التحية
Salvador = سلفادور
Salvadoran = السّلفادوريّ
Salvage = الإنقاذ
Salvageable = قابل للإنقاذ
Salvaged = منقذ
Salvager = المنقذ
Salvages = النقائذ
Salvaging = الإنقاذ
Salvation = الإنقاذ
Salvations = الإنقاذ
Salvatore = سالفاتور
Salve = المرهم
Salved = مدهون
Salver = الصينية
Salvers = الصواني
Salves = المراهم
Salving = الدهن
Salvo = الصلية
Salvos = الصليات
Salz = سالز
Sam = سام
Samaritan = سامري
Samaritans = السامريّون
Samarium = السمريوم -  عنصر معدني نفيس رماديّ باهت أو فضّي
Samba = السامبا
Same = نفسه
Sameness = التشابه
Sammy = سامي
Samoa = سامو
Samoan = السامون
Samovar = السماور
Sampan = القارب
Sampans = القوارب
Sample = العيّنة
Sampled = مختبر
Sampler = العيّنة
Samplers = العيّنات
Samples = العينات
Sampling = أخذ العينات
Samplings = أخذ العينات
Sampson = سابمسن
Samson = سامسن
Samuel = صموئيل
Samuels = صمويل
Samuelson = سامويلسون
San = سان
Sana = صنعاء
Sanatoria = المصحّات
Sanatorium = المصحّة
Sanatoriums = المصحّة
Sanborn = سانبورن
Sanchez = سانتشيز
Sancho = سانشو
Sanctification = التقديس
Sanctified = مقدّس
Sanctifier = المُقدِّس
Sanctifies = يقدّس
Sanctify = قدّس
Sanctifying = التقديس
Sanctimonies = النفاق
Sanctimonious = منافق
Sanctimoniously = بتظاهر بالتقوى
Sanctimoniousness = القدسية
Sanctimony = النفاق
Sanction = المقاطعة
Sanctioned = مقرّ
Sanctioning = الإقرار
Sanctions = العقوبات
Sanctities = القداسة
Sanctity = القداسة
Sanctuaries = الملاجئ
Sanctuary = الملجأ
Sanctum = المعتكف
Sanctums = المعتكفات
Sand = الرمل
Sandal = الصندل
Sandals = الصنادل
Sandalwood = خشب الصندل
Sandbag = كيس الرمل
Sandbags = أكياس الرمل
Sandbank = الشاطىء الرملي
Sandbars = الحواجز الرّمليّة
Sandblast = الجلي بالرمل
Sandblaster = المنظّف
Sandbox = الصندوق الرمل
Sandboxes = الصناديق الرمل
Sandburg = ساندبيرغ
Sanded = غطّى بالرمل
Sander = ماكينة صّقل الأرضيات
Sanderling = سانديرلينج - طائر بحريّ صغير
Sanders = ساندرز
Sanderson = ساندرسن
Sandhill = التلّ الرملي
Sandia = سانديا
Sandier = أكثر رمليّ
Sandiest = الأكثر رمليّ
Sandiness = الرّمليّة
Sanding = التغطية بالرمل
Sandman = المنوّم
Sandmen = المنوّمات
Sandpaper = ورق الصقل
Sandpapers = يصقّل
Sandpile = علبة الرّمل
Sandpiper = الطيطوي
Sandpipers = الطيطوي
Sandra = ساندرا
Sands = الرمال
Sandshoe = الحذاء المطّاطيّ
Sandshoes = الأحذية المطّاطيّة
Sandstone = الحجر الرملي
Sandstones = الأحجار الرملية
Sandstorm = العاصفة الرملية
Sandstorms = العواصف الرملية
Sandusky = ساندسكاي
Sandwich = السندويتش
Sandwiched = محصور
Sandwiches = السندويتشات
Sandwiching = الحصر
Sandy = ساندي
Sane = عاقل
Sanely = بشكل عاقل
Saneness = التعقّل
Saner = أعقل
Sanest = أعقل
Sanford = سانفورد
Sang = غنّى
Sangaree = السنجري - نوع من المشروبات
Sangfroid = الهدوء
Sangria = السانجريا
Sangrias = السانجريا
Sanguinarily = بشكل دموي
Sanguinary = دمويّ
Sanguine = متورّد
Sanguinely = بشكل متورّد
Sanguineness = التّفاؤل
Sanguineous = دمويّ
Sanhedrin = سانهيدرين - المجلس القضائيّ و الكنائسيّ العالي للأمّة اليهوديّة القديمة
Sanicle = سانيكل - نبات
Sanitaria = مستشفى
Sanitarian = صحّي
Sanitarily = صحيا
Sanitarium = المصح
Sanitariums = المصحّات
Sanitary = صحي
Sanitate = عقّم
Sanitation = تصريف المجاري
Sanitations = المرافق الصحية
Sanities = سلامة العقل
Sanitize = عقّم
Sanitized = جميل
Sanitizer = المطهّر
Sanitizes = يعقّم
Sanitizing = التعقيم
Sanity = سلامة العقل
Sank = غرق
Sans = سانس
Sanskrit = سنسكريتي
Sanskritic = سنسكريتي
Santa = بابا نويل
Santayana = سانتايانا
Santiago = سانتياغو
Santo = سانتو
Sao = ساو
Sap = الخندق
Sapience = الرشد
Sapiens = متعلق بالإنسان الحديث
Sapient = عاقل
Sapiently = بشكل عاقل
Sapless = شاحب
Sapling = الشتلة
Saplings = الشتلات
Saponify = صوبن
Sapped = مستنزف
Sapper = المهندس العسكري
Sappers = المهندسون العسكريون
Sapphire = الياقوت
Sapphires = الياقوت
Sappier = اكثر عصارة
Sappiest = الأكثر عصارة
Sappiness = الطّراوة، العُصارة
Sapping = الإستنزاف
Sappy = عصيري، أحمق
Saps = الخنادق
Sapsucker = سابسكير - من انواع نقّار الخشب
Sapwood = خشب
Sapwoods = خشب
Sara = ساره
Saracen = المسلم
Sarah = سيره
Saran = ساران - نوع من البلاستيك
Sarasota = ساراسوتا
Saratoga = ساراتوجا
Sarcasm = التهكّم
Sarcasms = التهكّمات
Sarcastic = ساخر
Sarcastical = ساخر
Sarcastically = بسخرية
Sarcoma = الورم اللحمي
Sarcomas = الأورام اللحمية
Sarcophagus = القبر
Sarcophaguses = القبور
Sardine = السردين
Sardines = السردين
Sardonic = تهكمي
Sardonically = بطريقة ساخرة
Sargent = سارجينت - رسّام أمريكيّ
Sari = الساري
Sarsaparilla = نبات الفشاغ
Sarsaparillas = نباتات الفشاغ
