Smelt = سمك الهف
Smelted = مصهور
Smelter = كانت رائحته
Smelteries = أوعية الصّهر
Smelters = أوعية الصّهر
Smeltery = مصنع للصهر
Smelting = الصهر
Smelts = الأسماك الفضية
Smidgen = الجزء الصّغير
Smidgens = الأجزاء الصّغيرة
Smile = الإبتسامة
Smiled = مبتسم
Smiler = المبتسم
Smiles = الإبتسامات
Smiley = وجه مبتسم
Smilies = الكتابات المعبّرة. مثل :-)
Smiling = الإبتسامة
Smilingly = بشكل مبتسم
Smirch = اللطخة
Smirched = ملطّخ
Smirches = اللطخات
Smirching = التلطيخ
Smirk = الإبتسامة
Smirked = مبتسم بتكلّف
Smirking = إبتسام بتكلّف
Smirks = الإبتسامات
Smite = إضرب
Smiter = الضّارب
Smites = يضرب
Smith = سميث
Smithereens = الأشتات
Smithfield = سميثفيلد
Smithies = مصانع الحدادة
Smiths = الحدادون
Smithson = سميثسن
Smithsonian = سمثسوني
Smithtown = سميثتاون
Smithy = الحدادة
Smiting = الضرب
Smitten = مغرم
Smock = الجلباب
Smocking = التطريز
Smocks = يطرّز
Smog = الدخان المضبّب
Smokable = قابل للتدخين
Smoke = الدخان
Smoked = مدخّن
Smokehouse = معمل لتدخين السمك او اللحم
Smokehouses = معامل لتدخين السمك او اللحم
Smokeless = بلا دخان
Smoker = المدخّن
Smokers = المدخنون
Smokes = الأدخنة
Smokescreen = دخان ساتر للجنود
Smokestack = المدخنة
Smokestacks = المداخن
Smokier = أكثر دخّانا
Smokiest = أكثر دخّانا
Smokily = بشكل دخاني
Smokiness = الدّخّان
Smoking = التدخين
Smoky = مدخّن
Smolder = إحترق
Smoldered = محترق
Smoldering = الإحتراق
Smolderingly = بشكل مشتعل
Smolders = يحترق
Smooch = عانق
Smooched = معانق
Smooches = يعانق
Smooching = المعانقة
Smooth = ناعم
Smoothbore = أملس
Smoothed = صقل
Smoothen = ملّس
Smoothened = مملّس
Smoothening = التمليس
Smoother = أنعم
Smoothes = يصقل
Smoothest = أنعم
Smoothie = عصير
Smoothing = الصقل
Smoothly = بيسر
Smoothness = النّعومة
Smooths = ينعّم
Smote = ضرب
Smother = إخنق
Smothered = مخنوق
Smothering = الخنق
Smothers = يخنق
Smoulder = إحترق
Smouldered = محترق
Smouldering = الإحتراق
Smoulders = يحترق
SMSA = المنطقة الإحصائيّة المدنية العاديّة
SMTP = بروتوكول نقل البريد الإلكتروني
Smucker = سموكير
Smudge = اللطخة
Smudge-proof = ضدّ اللطخة
Smudged = ملطّخ
Smudges = اللطخات
Smudginess = التّلطيخ
Smudging = التلطيخ
Smudgy = مشوّش
Smug = متعجرف
Smuggle = هرّب
Smuggled = مهرّب
Smuggler = المهرّب
Smugglers = المهرّبون
Smuggles = يهرّب
Smuggling = التهريب
Smugly = بشكل متعجرف
Smugness = الاعتزاز، الهندام، الترتيب
Smut = اللطخة
Smuts = اللطخات
Smuttier = أكثر سخاما
Smuttiest = أكثر سخاما
Smuttily = بشكل قذر
Smuttiness = البذاءة
Smutting = التسخيم
Smutty = مسخّم
Smyrna = سميرنا
Smythe = سميذي
Snack = الوجبة الخفيفة
Snackbar = الكافيتريا
Snacks = الوجبات الخفيفة
Snaffle = اللجام
Snaffles = اللجام
Snafu = اللخبطة
Snafued = لخبط
Snafuing = اللخبطة
Snafus = اللخبطات
Snag = العقبة
Snagged = متمزّق
Snagging = التمزّق
Snaggy = متعرّج
Snags = العقبات
Snail = الحلزون
Snail-wheel = عجلة حلزون
Snails = الحلزونات
Snake = الأفعى
Snakebird = سنيك بيرد - نوع من الطيور
Snakebite = لدغة الأفعى
Snakebites = لدغات الأفعى
Snaked = متلوّى
Snakelike = أفعوي
Snakeroot = سناكيروت - نبات
Snakes = الأفاعي
Snakeskin = جلد الثّعبان
Snakier = أفعوي
Snakiest = أفعوي
Snakily = بشكل أفعوي
Snaking = التلوّي
Snaky = أفعوي
Snap = الطقّة
Snap-out = عضّ خارج
Snapback = يتعافى، ينتعش
Snapdragon = أنف العجل
Snapdragons = نباتات أنف العجل
Snapped = معضوض
Snapper = النهّاش
Snappers = النهّاشات
Snappier = أكثر نزقا
Snappiest = أكثر نزقا
Snappily = بشكل نشيط
Snappiness = الحيويّة
Snapping = العضّ
Snappish = نزق
Snappishly = بشكل نزق
Snappishness = الفظاظة
Snappy = نزق
Snaps = الطقّات
Snapshot = اللقطة
Snapshots = اللقطات
Snare = الفخّ
Snared = مصطاد
Snarer = الصّياد
Snares = الأفخاخ
Snarf = سنارف
Snaring = الإصطياد
Snark = حدث لا تفسير له في الكومبيوتر
Snarl = الزمجرة
Snarled = مزمجر
Snarler = المُعقِّد
Snarling = الزمجرة
Snarls = يزمجر
Snatch = الخطف
Snatched = مختطف
Snatcher = الخطّاف
Snatches = الخلسة
Snatching = الإختطاف
Snazzier = أكثر أناقة
Snazzy = أنيق
Snead = سنيد
Sneak = الخائن
Sneaked = منسلّ
Sneaker = أولي
Sneakered = لابس حذاء
Sneakers = أحذية الرياضة
Sneakier = أكثر سرّانية
Sneakiest = أكثر سرّانية
Sneakily = بشكل حقير
Sneakiness = المخادعة
Sneaking = الإنسلال
Sneakingly = بشكل خفيّ
Sneaks = الخونة
Sneaky = مخادع
Sneed = مقبض المنجل
Sneer = إحتقر
Sneered = محتقر
Sneerer = السّاخر
Sneerers = السّاخرون
Sneering = الإحتقار
Sneers = يحتقر
Sneeze = العطاس
Sneezed = عاطس
Sneezer = العاطس
Sneezes = العطس
Sneezing = العطس
Snell = الخيط الرّابط بين الشّص وخيط الصيد الرئيسي
Snick = النقرة
Snicker = القرقرة
Snickered = ضاحك
Snickerer = الضّاحك
Snickering = الضحك
Snickers = السنكرز
Snide = دنيئ
Snidely = بشكل دنيئ
Snideness = التّعريض، التزييف
Snider = دنيئ
Snidest = دنيئ
Sniff = الشمّة
Sniffed = مشموم
Sniffer = متشمّم
Sniffier = أكثر تكبّر
Sniffiest = الأكثر تكبّر
Sniffiness = التكبّر
Sniffing = الشمّ
Sniffle = إشهق
Sniffled = شاهق
Sniffler = المستنشق
Sniffles = يشهق
Sniffling = الشهيق
Sniffly = إستنشاقي، شهيقي
Sniffs = الشمّة
Sniffy = متكبّر
Snifter = جرعة الكحول
Snigger = القرقرة
Sniggered = ضاحك
Sniggering = الضحك
Sniggers = القرقرات
Snip = القصاصة
Snipe = الشنقب
Sniped = مقنوص
Sniper = القنّاص
Snipers = القنّاصون
Snipes = الشّنقب
Sniping = القنص
Snipped = مقصوص
Snipper = القطّاع - قطّاع الورق، قطّاع القماش، الخ
Snippet = القصاصة
Snippets = القصاصات
Snippier = لسانه اكثر سلاطة
Snipping = القصّ
Snippy = سليط اللسان
Snips = القصاصات
Snit = الضّيق
Snitch = أخبر عنه
Snitched = مخبر عن
Snitches = يخبر عنه
Snitching = الإخبار عن
Snits = الضّيق
Snivel = إبك
Sniveled = بكى
Sniveler = الباكي
Snivelers = الباكون
Sniveling = البكاء
Snivelling = البكاء
Snivels = يبكي
Snob = المتأبّه
Snobbery = التأبه
Snobbier = أكثر تكبّرا
Snobbiest = أكثر تكبّرا
Snobbish = متكبّر
Snobbishly = بشكل متكبّر
Snobbishness = التكبّر
Snobby = متكبّر
Snobs = المتأبّهون
Snodgrass = سنودجراس - شاعر أمريكيّ
Snook = سنوك - نوع من الأسماك
Snooker = السنوكر
Snookers = يعيق
Snooks = سنوكس - جمع سمكة السنوك
Snoop = تطفّل
Snooped = متطفّل
Snooper = المتلصّص
Snoopers = المتلصّصون
Snoopier = أكثر تطفّل
Snoopiest = الأكثر تطفّل
Snooping = التطفّل
