Surgical = جراحي
Surgically = جراحيا
Surging = الإندفاع
Suriname = سورينام
Surjection = سيرجيكشن - عملية رياضيّة
Surlier = أشدّ فضاضة
Surliest = أشدّ فضاضة
Surlily = بشكل فظّ
Surliness =  الفظاظة
Surly = فظّ
Surmise = التخمين
Surmised = مظنون
Surmiser = المخمّن
Surmises = الظنون
Surmising = الظنّ
Surmount = إقهر
Surmounted = مقهور
Surmounting = القهر
Surmounts = يقهر
Surname = اللقب
Surnamed = ملقّب
Surnames = الألقاب
Surpass = فق
Surpassable = ممكن التغلب عليه
Surpassed = مفاق
Surpasses = يفيق
Surpassing = الإفاقة
Surpassingly = بشكل تجاوزي
Surplice = الرداء الكهنوتي
Surplices = الأردية الكهنوتية
Surplus = الفائض
Surpluses = الفائض
Surprisal =  المباغتة
Surprise = المفاجأة
Surprised = مفاجئ
Surpriser = مفاجئ
Surprises = المفاجئات
Surprising = المفاجئة
Surprisingly = باندهاش
Surreal = سريالي
Surrealism = السريالية
Surrealist = سريالي
Surrealistic = سريالي
Surrealistically =  بشكل سرياليّ
Surrealists = السرياليون
Surrender = الإستسلام
Surrendered = مستسلم
Surrenderer = المستسلم
Surrendering = الإستسلام
Surrenders = الإستسلام
Surreptitious = سرّي
Surreptitiously = بشكل سري
Surreptitiousness = السّرّيّة
Surrey = الحنطور
Surreys = الحناطير
Surrogate = البديل
Surrogated = عيّن
Surrogates = البدائل
Surrogating = التعيين
Surrogation = إستبدال الأشخاص
Surround = المحيط
Surrounded = محاط
Surrounding = الإحاطة
Surroundings = البيئة المحيطة
Surrounds = الحواشي
Surtax = الضريبة الإضافية
Surtaxes = الضرائب الإضافية
Surtout = المعطف
Surveillance = المراقبة
Surveillances = المراقبات
Surveillant = المراقب
Survey = المسح
Surveyed = ممسوح
Surveying = المسح
Surveyor = المسّاح
Surveyors = المسّاحون
Surveys = الإستطلاعات
Survivability = قابلية البقاء
Survivable = قادر على البقاء حي
Survival = البقاء
Survivalist = المكافح
Survivalists = المكافحون
Survivals = البقاء
Survive = إبق
Survived = باق
Surviver =  النّاجي
Survives = يبقى
Surviving = البقاء
Survivor = الباق على قيد الحياة
Survivors = الباقون على قيد الحياة
Survivorship = الوراثة
Sus = إحزر
Susan = سوزان
Susanne = سوزان
Susceptance = القبول، الحساسية
Susceptibility = سهولة التأثّر
Susceptible = سريع التأثير
Susceptibleness = الحساسية، القبول
Susceptibly = بشكل حساس
Susceptively = بشكل عرضة
SuSE = سوسإ
Sushi = السوتشي
Susie = سوزي
Suspect = المشتبه به
Suspected = مشكوك فيه
Suspecter = مشبوه
Suspecting = الشكّ
Suspects = المشتبه بهم
Suspend = علّق
Suspended = معلّق
Suspender = الحمّالة
Suspenders = الحمّالات
Suspending = التعليق
Suspends = يعلّق
Suspense = الترقّب
Suspenses = الترقب
Suspension = التعليق
Suspensions = التوقيف
Suspensive = تعليقي
Suspensively = بشكل تعليقي
Suspensor = حامل وواقي العضو الذّكري في الرياضات العنيفة
Suspensory = تعليقي
Suspicion = الشكّ
Suspicioned = شكّ، إرتاب، لم يشعر بالإرتياح
Suspicioning = يرتاب من..
Suspicions = الشكوك
Suspicious = مثير للشكّ
Suspiciously = بصورة مريبة
Suspiciousness = الشّكّ
Susquehanna =  سسكويهانا - نهر في شرق الولايات المتّحدة
Sussex = مملكة السوسيكس
Sustain = تحمّل
Sustainable = مستمر
Sustained = ثابت
Sustainer = الرزّاق
Sustaining = التحمّل
Sustainment = الإستمرارية
Sustains = يتحمّل
Sustenance = المعيشة
Sustenances = المعيشة
Sutherland =  ساذرلاند - قانونيّ و سياسيّ أمريكي بريطاني المولد
Sutton = ساتن
Suture = الخياطة
Sutured = مخيّط
Sutures = الخياطات
Suturing = التخييط
Suwanee = سواني
Suzanne = سوزان
Suzerain =  الدّولة المهيمنة
Suzerainty = الهيمنة
Suzuki = سوزوكي
Svelte = رشيق
Sveltely = بشكل رشيق
Svelteness = الرّشاقة
SW = جنوب غربي
Swab = المسحة
Swabbed = ممسوح
Swabbies = بحّارة
Swabbing = المسح
Swabby = بحّار
Swabian = مواطن من سوابيا
Swabs = المسحات
Swaddle = قمّط
Swaddled = مقمّط
Swaddles = يقمّط
Swaddling = التقميط
Swag = البضائع المسروقة
Swage = القالب
Swagger = التبختر
Swaggered = متبختر
Swaggerer = مزهو
Swaggering = التبختر
Swaggeringly = مختالاً
Swaggers = التبختر
Swaging = ثني المعادن وتشكيلها
Swahili = سواهيلي
Swain = القروي العاشق
Swains = القرويون العاشقون
Swallow = الجرعة
Swallowed = مبتلع
Swallower = المُبتلع
Swallowing = البلع
Swallows = الجرعات
Swallowtail = ذيول المعطف
Swallowtails = ذيول المعطف
Swam = سبح
Swami = السوامي
Swamp = المستنقع
Swamped = غارق
Swamper =  ساكن المستنقعات
Swampier = مستنقعي
Swampiest = مستنقعي
Swampiness = الوُحوْلة
Swamping = الغرق
Swampland = المستنقع
Swamplands = المستنقعات
Swamps = المستنقعات
Swampy = مستنقعي
Swan = البجعة
Swang = المستنقع
Swank = التباهي
Swanker = المُختال
Swankier = أكثر إختيالا
Swankiest = الأكثر إختيالا
Swankily = بخُيلاء
Swankiness = الفخامة
Swanky = فاخر
Swanlike = كما البجعة
Swans = البجعات
Swanson = سوانسون
Swap = التبادل
SwapBackground = التبديلالخلفية
Swapped = مبدّل
Swapper = المقايض
Swapping = التبديل
Swaps = المقايضات
Sward = المرجة
Swards = المروج
Swarm = الحشد
Swarmed = معجوج
Swarmer = المتجمّع، المتجمهر
Swarming = العجّ
Swarms = الحشود
Swart = أسمر
Swarthier = أسمر
Swarthiness = السُّمْرة
Swarthmore = سوارثمور
Swarthout = سوارثاوت
Swarthy = الأسمر
Swartness = السُّمْرة
Swartz = شوارتز
Swash = ترشرش
Swashbuckler = المتعنتر
Swashbucklers = المتعنترون
Swashed = مترشرش
Swasher = من يستعرض قوّة ذراعيه
Swashes = يترشرش
Swashing = الترشرش
Swastika = الصليب المعقوف
Swastikas = علامات الصليب المعقوف
Swat = إسحق
Swatch = القطعة
Swatches = القطعة
Swath = المساحة
Swathe = المساحة
Swathed = مربوط
Swather = سواثر
Swathes = المساحات
Swathing = الربط
Swaths = المساحات
Swats = يسحق
Swatted = مسحوق
Swatter = منشّة الحشرات
Swatting = السحق
Sway = السيطرة
Swayed = مذبذب
Swayer = سواير
Swaying = الذبذبة
Sways = يذبذب
Swaziland = سوازيلاند
Swear = أقسم
Swearer =  الشّاتم، المتعهّد
Swearing = القسم
Swears = يقسم
Swearword = اللعنة
Swearwords = اللعنات
Sweat = العرق
Sweatband = العصابة
Sweatbands = العصابات
Sweatbox = جهاز التجفيف
Sweatboxes = أجهزة التجفيف
Sweated = متعرّق
Sweater = البلوز
Sweaters = البلوزات
Sweatier = أكثر تعرّقا
Sweatiest = أكثر تعرّقا
Sweatily = بعرق
Sweatin = سويتين
Sweatiness = مقدار العرق على الجسم
Sweating = التعرّق
Sweats = العرق
Sweatshirt = البلوز
Sweatshop = محل العمل الشاقّ
Sweatshops = محلات العمل الشاقّ
Sweaty = متعرّق
Swede = السويدي
Sweden = السويد
Swedes = السويديون
Swedish = سويدي
Sweeney = سويني
Sweep = التفتيش
Sweeper = الكنّاس
Sweepers = الكنّاسون
Sweeping = الكناسة
Sweepingly = بشكل شامل
Sweepingness = الكنس
Sweepings = الكناسة
Sweeps = عمليات المسح
Sweepstake = رهان سباق الخيل
Sweepstakes = مراهنات سباق الخيل
