Sweet = الحلوى
Sweetbread = بنكرياس العجل
Sweetbreads = بنكرياسات العجول
Sweeten = حلّ
Sweetened = محلّى
Sweetener = المحلّي
Sweeteners = المحلّيات
Sweetening = التحلية
Sweetenings = موادّ التّحلية
Sweetens = يحلّي
Sweeter = أحلى
Sweetest = أحلى
Sweetheart = الحبيب
Sweethearts = الأحبّة
Sweetie = الحبّوب
Sweeties = المحبوبون
Sweeting = التّفّاح
Sweetish = حلو
Sweetishly = بشكل حلو
Sweetly = بشكل حلوّ
Sweetmeat = الحلوى
Sweetmeats = الحلويات
Sweetness = الحلاوة
Sweets = الحلويات
Swell = الإنتفاخ
Swelled = إنتفخ
Swelling = الورم
Swellings = الأورام
Swells = الإنتفاخات
Swelt = سويلت
Swelter = إحترّ
Sweltered = محترّ
Sweltering = الإحترار
Swelteringly = بشكل محترّ
Swelters = يحترّ
Swenson = سوينسون -  شاعر أمريكي
Swept = كنس
Swerve = الإنحراف
Swerved = منقلب
Swerves = الإنحرافات
Swerving = الإنقلاب
Swift = السمامة
Swifter = أسرع
Swiftest = أسرع
Swiftly = بسرعة شديدة
Swiftness = السّرعة
Swig = إكرع
Swigged = مكروع
Swigging = الكرع
Swigs = يكرع
Swill = الفضلة
Swilled = مشطوف
Swilling = الشطف
Swills = الفضلات
Swim = السباحة
Swimmer = السبّاح
Swimmers = السبّاحون
Swimming = السباحة
Swimmingly = بسهولة
Swims = يسبح
Swimsuit = كسوة السباحة
Swimsuits = كسوات السباحة
Swinburne =  سوينبرن - شاعر و ناقد بريطاني
Swindle = الإحتيال
Swindled = مخدوع
Swindler = النصّاب
Swindlers = النصّابون
Swindles = الإحتيالات
Swindling = الخدع
Swine = الخنزير
Swineherd = مربي الخنازير
Swineherds = مربو الخنازير
Swines = الخنازير
Swing = التحوّل
Swinger = عاهر أو عاهرة
Swingers = العهرة او العاهرات
Swingier = أكثر إيقاعاً
Swinging = الضرب
Swingingly = بشكل دائر
Swings = الأراجيح
Swingy = إيقاعي
Swinish = دنيئ
Swinishly = بشكل دنيئ
Swinishness = الوقاحة
Swipe = الضربة الشديدة
Swiped = مضروب
Swipes = الضربات الشديدة
Swiping = الضرب
Swirl = الدوّامة
Swirled = ملتفّ
Swirlier = أكثر التفافاً، التواءاً
Swirling = الإلتفاف
Swirlingly = بشكل دوّار
Swirls = الدوّامات
Swirly = دوّامي
Swish = ممتاز
Swished = محفوف
Swisher = سويشر
Swishes = يحفّ
Swishier = أكثر تصفيراً
Swishing = الحفّ
Swishy = سويشي
Swiss = السويسري
Switch = المفتاح
Switchback = الطّريق المتعرّج
Switchbacks = التعرّجات
Switchblade = المطواة
Switchblades = المطاوي
Switchboard = لوحة المفاتيح
Switchboards = لوحات المفاتيح
Switched = تحوّل
Switcher = عامل التّحويلة، الجلّاد
Switches = المفاتيح
Switchgear = أجهزة توصيل الكهرباء
Switching = التحويل
Switchings = التحويلات
Switchman = عامل التّحويلة
Switchmen = عمّال التّحويلة
Switchyard = الفناء
Switchyards = الأفنية
Switzer = السّويسريّ
Switzerland = سويسرا
Swivel = دوّار
Swivel-mounted = الدوّار الصاعد
Swiveled = دار، التفّ
Swiveling = الدّوران
Swivels = يدور
Swizzle = أفرط
Swizzled = مفرط
Swizzler = شارب الخمر المفرط
Swizzling = الإفراط
Swollen = متورّم
Swoon = الإغماء
Swooned = مصاب بالإغماء
Swooner = المصاب بالإغماء
Swooning = إصابة بالإغماء
Swooningly = بفقدان للوعي
Swoons = الإغماء
Swoop = الإنقضاض
Swooped = منقضّ على
Swooper = المهاجم
Swooping = الإنقضاض على
Swoops = الإنقضاض
Sword = السيف
Swordfish = سمك السيف
Swordfishes = سمك السيف
Swordplay = المبارزة
Swordplayer = المبارز
Swords = السيوف
Swordsman = المبارز
Swordsmanship = مهارة المبارزة
Swordsmen = المبارزون
Swordtail = السّرتيل - سمك نهريّ
Swore = أقسم
Sworn = مقسم
Swum = سابح
Swung = متأرجح
Sybarite = المترف
Sybarites = المترفون
Sybaritic = مترف
Sybil = سيبيل
Sycamore = الجمّيز
Sycamores = الجمّيز
Sycophancy = التّملّق
Sycophant = المتملق
Sycophantic = متملّق
Sycophantical = متعلق بالتملّق
Sycophantically = بتملّق
Sycophantly = بتملّق
Sycophants = المتملقون
Sydney = سدني
Syenite = الصّخر
Sykes = سيكيس
Syllabi = المناهج الدراسية
Syllabic = مقطعي
Syllabically = على نحو مقطعيّ
Syllabication = تقطيع الكلام
Syllabicity = مقطعية الكلام
Syllabification = التّقطيع
Syllabify = قطّع
Syllable = المقطع
Syllabled = ملفوظ بمقاطع
Syllables = المقاطع
Syllabling = لفظ بمقاطع
Syllabus = المنهج الدراسي
Syllabuses = المناهج الدراسية
Syllogism = القياس المنطقي
Syllogisms = القياس المنطقي
Syllogistic = قياسي
Sylph = الرّشيقة
Sylphs = الرّشيقات
Sylvan = غابيّ
Sylvania = سيلفانيا
Sylvester = سيلفيستر
Sylvia = سيلفيا
Sylvie = سيلفي
Symbiont = المتكافل
Symbiosis = التّكافل
Symbiotic = تعايشي
Symbiotically = بطريقة تكافليّة
Symbol = الرمز
Symboled = علّم بعلامة
Symbolic = رمزي
Symbolical = رمزي
Symbolically = بشكل رمزي
Symbolics = دراسة الرّموز القديمة
Symboling = يعلّم بعلامة
Symbolism = الرمزيّة
Symbolisms = الرمزيّة
Symbolists = الرمزيون
Symbolization = الرّمز
Symbolize = مثّل
Symbolized = ممثّل
Symbolizer = المتخصص في الرّموز
Symbolizes = يمثّل
Symbolizing = التمثيل
Symbols = الرموز
Symington = سيمينجتون - سياسيّ أمريكيّ
Symmetric = متماثل
Symmetrical = متماثل
Symmetrically = بشكل متماثل
Symmetricalness = التّماثل
Symmetries = التناظر
Symmetry = التناظر
Sympathetic = متعاطف
Sympathetical = متعلق بالتعاطف
Sympathetically = عاطفيا
Sympathies = التعاطف
Sympathize = تعاطف
Sympathized = متعاطف
Sympathizer = المتعاطف
Sympathizers = المتعاطفون
Sympathizes = يتعاطف
Sympathizing = التعاطف
Sympathizingly = بصورة متعاطفة
Sympathy = العطف
Symphonic = سيمفوني
Symphonically = تناغمياً
Symphonies = السمفونيات
Symphony = السمفونية
Symplectic = الرّبط
Symposia = الحلقات الدراسية
Symposium = الحلقة الدراسية
Symposiums = الحلقات الدراسية
Symptom = العلامة
Symptomatic = عرضي
Symptomatically = عرضيا
Symptomatology = طب الأعراض
Symptoms = الأعراض
Syn = سين كانت ربّة في أساطير النورس
Synagogue = الكنس
Synagogues = المعابد
Synapse = الوصلة العصبية
Synapsed = متشابك، تشابك
Synapses = الوصلات العصبية
Synapsing = التشابك
Synaptic = متشابك
Sync = المصاحبة
Synced = مزامن
Synchromesh = التعشيق التزامني
Synchronism = التّزامن
Synchronistic = متزامن
Synchronistically = بشكل متزامن
Synchronization = التزامن
Synchronizations = التزامن
Synchronize = زامن
Synchronized = مزامن
Synchronizer = مقياس التّزامن
Synchronizes = يزامن
Synchronizing = المزامنة
Synchronous = متزامن
Synchronously = بشكل متزامن
Synchronousness = التزامن
Synchrony = التّزامن
Synchrotron = السنكروترون
Syncing = المزامنة
Syncopate = أدغم
Syncopated = مدغم
Syncopates = يدغم
Syncopating = الإدغام
Syncopation = الإختزال
Syncopations = الإختزال
Syncopative = إيقاع موسيقي
Syncope = الغشيان
Syncs = المصاحبة
Syndic = الموظف الإداري
Syndicate = النقابة
Syndicated = واسع الإنتشار
Syndicates = النقابات
Syndicating = تشكيل نقابة
Syndication = التّرويج
Syndics = الموظفون الإداريون
Syndrome = المتلازمة
Syndromes = المتلازمات
Synergetic = متعاون
Synergism = التّعاون
Synergistic = تعاونيّ
Synergy = التعاون
Synge = سينج - كاتب مسرحيّ أيرلنديّ
Synod = المجمع الكنسي
