Tessellates = يغطي بالفسيفساء
Tessellating = التغطية بالفسيفساء
Tessellation = التغطية بالفسيفساء
Tessie = تيسي
Test = الإختبار
Test-bench = مقعد إختبار
Testability = قابليّة الاختبار
Testable = قابل للاختبار
Testament = الوصيّة
Testamentary = وصائي
Testaments = الوصايا
Testate = الموصي
Testator = الموصي
Testators = الموصون
Testatrix = الموصية
Testatrixes = الموصية
Tested = مجرّب
Tester = الفاحص
Testers = الفاحصات
Testes = الخصيات
Testicle = الخصية
Testicles = الخصيات
Testicular = خصيوي
Testier = حاد الطبع
Testiest = حاد الطبع
Testified = شاهَد
Testifier = شاهِد
Testifiers = شُهود
Testifies = يشهد
Testify = إشهد
Testifying = الشهادة
Testily = بحدّة طبع
Testimonial = التزكية
Testimonials = التزكيات
Testimonies = الشهادات
Testimony = الشهادة
Testiness = حدّة الطبع
Testing = الإختبار
Testings = الإختبار
Testis = الخصية
Testosterone = التيستوستيرون
Tests = الإختبارات
Testudo = درع
Testy = حاد الطبع
Tetanus = داء الكزاز
Tete = الشَّعر المستعار
Tether = الحبل
Tethered = مربوط
Tethering = الربط
Tethers = الحبال
Tetrachloride = رباعي الكلوريد
Tetracycline = تيترسيكلين
Tetrade = مجموعة من 4
Tetrafluoride = رباعي الفلوريد
Tetragonal = رباعيّ الأضلاع
Tetragonally = على شكل رباعيّ الأضلاع
Tetrahalide = رباعيّات الهالوجين
Tetrahedra = رباعي الأسطح
Tetrahedral = رباعي الأسطح
Tetrahedrally = بشكل رباعي الأسطح
Tetrahedron = رباعي الأسطح
Tetrahedrons = رباعيات الأسطح
Tetrameter = ذو أربعة مقاسات
Tetrameters = ذوي أربعة مقاسات
Tetrasodium = رباعي الصوديوم
Tetravalent = رباعيّ التكافؤ
Teutonic = توتوني
TeX = تكس
Texaco = تيكساكو
Texan = تكساسي
Texas = تكساس
Text = النصّ
Textbook = الكتاب الدراسي
Textbooks = الكتب الدراسية
TextContentsToHeight = توسعة المحتويات لارتفاع الكائن
Textile = المنسوج
Textiles = المنسوجات
Textquote = إقتباس نص
TextRSS = نص
Texts = النصوص
Textual = نصّي
Textually = نصيا
Textural = تركيبيّ
Texturally = بشكل تركيبيّ
Texture = تركيب
Textured = مركّب
Textures = القوام
Texturing = التّركيب
Th = ث
Thai = التايلانديون
Thailand = تايلند
Thalamic = مهادي
Thalamus = المهاد
Thalia = ثاليا
Thallium = الثاليوم
Thallophyte = المَشْريّة
Thames = التايمز
Than = من
Thank = إشكر
Thanked = مشكور
Thanker = شاكر
Thankful = متشكّر
Thankfully = شكرا
Thankfulness = التّشكّر
Thanking = الشكر
Thankless = ناكر للجميل
Thanklessly = بنكران جميل
Thanklessness = نكران الجميل
Thanks = شكرا
Thanksgiving = عيد الشكر
Thanksgivings = أعياد الشكر
That = ذلك
Thatch = القشّ
Thatched = مسقّف
Thatcher = مُسقِف
Thatches = القشّ
Thatching = تسقيف
Thaw = الذوبان
Thawed = مذاب
Thawing = الذوبان
Thaws = الذوبان
Thayer = ثاير
The = الـ
Thea = ثيا
Theater = المسرح
Theatergoer = إلْفُ المسارح
Theatergoers = إلْفو المسارح
Theatergoing = إلفَة المسارح
Theaters = المسارح
Theatre = المسرح
Theatregoer = مرتاد المسرح
Theatregoers = رواد الالمسرح
Theatres = المسارح
Theatric = مسرحيّ
Theatrical = مسرحي
Theatrically = مسرحياً
Theatricals = الأدوار المسرحية
Theatrics = التمثيل المسرحي
Thebes = الثيبات
Thee = أنت
Theft = السرقة
Thefts = السرقات
Their = هم
Theirs = لهم
Theism = الإيمان بالله
Theist = المؤمن
Theistic = إيمانيّ
Theistical = إيمانيّ
Theistically = بشكل إيمانيّ
Thelma = ثيلما
Them = هم
Thematic = موضوعي
Thematically = بشكل موضوعيّ
Theme = الموضوع
Themes = المواضيع
Themselves = أنفسهم
Then = ثمّ
Thence = من ثمَّ
Thenceforth = من ذلك الحين فصاعداً
Thenceforward = من ذلك الحين فصاعداً
Thenceforwards = من ذلك الحين فصاعداً
Theocracy = الحكومة الدينية
Theocrasy = الإشراك
Theocratic = ثيوقراطي
Theocratically = بشكل ثيوقراطي
Theodore = ثيودور
Theodosian = ثيودوسيّ
Theodosius = ثيودوسيوس
Theologian = العالم الديني
Theologians = علماء الدين
Theologic = ﻻهوتيّ
Theological = لاهوتيّ
Theologically = بشكل لاهوتيّ
Theologies = الأنظمة اللاهوتيّة
Theology = نظام اللاهوت
Theorem = النظرية
Theorems = النظريات
Theoretic = نظري
Theoretical = نظري
Theoretically = نظرياً
Theoretician = الباحث في الجانب النّظري
Theoreticly = بشكل نظري
Theoretics = نظريات
Theories = النظريات
Theorist = العالم النظري
Theorists = العلماء النظريون
Theorization = وضع النظريات
Theorize = فسّر
Theorized = مفسّر
Theorizer = واضع النظرية
Theorizes = ينظّر
Theorizing = التنظير
Theory = النظرية
Theosophic = تصوّفي
Theosophical = تصوّفي
Theosophically = بشكل تصوّفي
Theosophies = التصوّف
Theosophist = المتصوّف
Theosophy = التصوّف
Therapeutic = علاجّي
Therapeutical = علاجي
Therapeutically = بشكل علاجي
Therapeutics = علم التداوي
Therapies = العلاج
Therapist = المعالج
Therapists = المعالجون
Therapy = العلاج
There = هناك
Thereabout = ما يقرب من ذلك
Thereabouts = ما يقرب من ذلك
Thereafter = فيما بعد
Thereat = بذلك
Thereby = بذلك
Therefor = لذلك
Therefore = لذا
Therefrom = من هناك
Therein = في ذلك المكان
Thereinafter = في الجزء التالي
Thereof = من ذلك
Thereon = على ذلك
Theresa = تيريسا
Thereto = على
Theretofore = حتى ذلك الحين
Thereunder = تحت ذلك
Thereupon = عقب ذلك
Therewith = مع ذلك
Thermal = التيار الدافئ
Thermally = حراريا
Thermals = التيارات الدافئة
Thermic = حراري
Thermionic = الثّرميونيّ
Thermionics = الثرميونيات
Thermistor = الثَّرْمِستور
Thermistors = الثَّرْمِستورات
Thermo = كهربائي حراري
Thermocouple = المزدوجة الحرارية
Thermocouples = المزدوجات الحرارية
Thermodynamic = ديناميكي حراريّ
Thermodynamically = بشكل ديناميكي حراري
Thermodynamics = الديناميكا الحرارية
Thermoelastic = مطّاطي حراري
Thermoelectric = كهربائي حراري
Thermoformed = شُكّل بالحرارة والضغط
Thermoforming = التّشكيل بالحرارة والضغط
Thermogravimetric = مقياس الثقل النوعي الحراري
Thermometer = ميزان الحرارة
Thermometers = ميزان الحرارة
Thermometric = قياس حراريّ
Thermometrical = قياس حراريّ
Thermometrically = بشكل يقيس الحرارة
Thermometry = قياس الحرارة
Thermonuclear = نووي حراري
Thermopile = عمود الحرارة
Thermoplastic = لَدْن بالحرارة
Thermoplastics = لوادن الحرارة
Thermos = الترمس
Thermoses = الترمس
Thermosetting = صلدٌ بالحرارة
Thermosflask = الترمس
Thermostable = ثابت بالحرارة
Thermostat = منظم الحرارة
Thermostated = منظّم بالثرموستات
Thermostatic = ثرموستاتي
Thermostatically = حراريا
Thermostatics = ثرموستاتيات
Thermostats = منظمات الحرارة
Thesauri = قواميس المعاني
Thesaurus = قاموس المعاني المرادفة
These = هذه
Theses = الإطروحات كما أطروحات الدّراسات العليا
Theseus = ثيزيوس - بطل و ملك أثينا. الأساطير اليونانيّة
Thesis = الأطروحة - كما أطروحات الدّراسات العليا
Thespian = ممثّل مسرحي
Thespians = ممثّلون مسرحيّون
Theta = ثيتا - الحرف الثامن في الأبجدية اليونانية
Thetis = ثيتيس - إحدى ال50 حوريّة الماء. الأساطير اليونانيّة
Thews = عضلات
They = هم
Thiamin = الثّيامين
Thiamine = الثّيامين
Thick = سميك
Thick-film = الفلم السميك
Thicken = إثخن
Thickened = ثخن
Thickener = مُثخن
Thickeners = مُثخنات
Thickening = التثخّن
Thickens = يثخن
Thicker = أثخن
Thickest = أثخن
Thicket = الأجمة
Thicketed = مؤجم
Thickets = الأجمات
Thickhead = غبيّ
Thickheaded = غبيّ
Thickish = مائل إلى السُّمكة
Thickly = بشكل كثيف
Thickness = السّماكة
Thicknesses = السّماكات
Thickset = ضخم الجثة
