Thief = اللصّ
Thiensville = ثينزفيل
Thieve = إسرق
Thieved = مسروق
Thievery = اللصوصية
Thieves = اللصوص
Thieving = السرقة
Thievish = لصوصي
Thievishly = بشكل لصوصي
Thievishness = اللّصوصيّة
Thigh = الفخذ
Thighbone = عظم الفخذ
Thighbones = عظم الفخذ
Thighed = مفخذ
Thighs = الأفخاذ
Thimble = الكشتبان
Thimbles = الكشتبانات
Thimbu = ثيمبو
Thin = رقيق
Thine = ذين
Thiner = أرقّ
Thinest = أرقّ
Thing = الشيء
Thingamajig = مجهول الإسم
Thingamajigs = مجهولوا الإسم
Thingness = الواقعيّة
Things = الأشياء
Think = إعتقد
Thinkable = قابل للتحقيق
Thinkableness = قابلية التحقيق
Thinkably = بشكل قابل للتحقيق
Thinker = المفكّر
Thinkers = المفكّرون
Thinking = التفكير
Thinkingly = بشكل مفكّر
Thinkingness = التفكّر
Thinks = يعتقد
Thinly = بشكل رقيق
Thinned = مخفّف
Thinner = أنحف
Thinners = ذينيرس
Thinness = النحافة
Thinnest = أنحف
Thinning = التخفيف
Thinnish = ذو نحافة
Thins = يخفّف
Thiocyanate = ملح حامض الثيونيك
Thiouracil = ثوراسل - مركب كيميائي
Third = الثلث
Thirdly = ثالثا
Thirds = الأثلاث
Thirst = العطش
Thirsted = عطش
Thirster = متعطّش
Thirstier = أشدّ عطشا
Thirstiest = الأشدّ عطشا
Thirstily = بشكل عطشان
Thirstiness = العطش
Thirsting = التّعطّش
Thirsts = العطش
Thirsty = عطشان
Thirteen = ثلاثة عشر
Thirteens = في الثالثة عشرة
Thirteenth = الثالث عشر
Thirties = الثلاثينات
Thirtieth = ثلاثون
Thirty = ثلاثون
This = هذا
Thistle = الشوك
Thistledown = زغب الشوك
Thistles = الأشواك
Thistly = ذيسلي
Thither = إلى هناك
Thithertho = حتى ذلك الحين
Tho = مع ذلك
Thole = يتحمّل
Thomas = توماس
Thomistic = تومانيّ
Thompson = توبمسن
Thomson = تومسن
Thong = سَيْر جلدي
Thonged = ارتدى سيْراً جلدياً
Thongs = سيور جلدية
Thor = ثور
Thoracic = صدري
Thorax = الصدر
Thoraxes = الصدور
Thoreau = ثورو
Thoriate = الثّوريات
Thoriated = الضحكة الهستيرية
Thorium = الثوريوم
Thorn = الشوكة
Thornburg = ثورنبيرغ
Thornier = أكثر تعقيدا
Thorniest = أكثر تعقيدا
Thornily = بمشاكل
Thorniness = الإشاكة
Thornless = عديم الشّوك
Thorns = الأشواك
Thornton = ثورنتن
Thorny = شائك
Thorough = شامل
Thoroughbred = أصيل
Thoroughbreds = الأصيلون
Thoroughfare = الطريق
Thoroughfares = الطرق
Thoroughgoing = أصيل
Thoroughly = كليّا
Thoroughness = الإتقان
Thorpe = ثورب
Thorstein = ثورستاين
Those = أولئك
Thou = أنت
Though = ولو أنّ
Thought = الفكر
Thoughtful = مدروس
Thoughtfully = بشكل مدروس
Thoughtfulness = المراعاة
Thoughtless = طائش
Thoughtlessly = بشكل طائش
Thoughtlessness = الطّيش
Thoughts = الأفكار
Thousand = ألف
Thousandfold = ألف ضعف
Thousands = الآلاف
Thousandth = الألف
Thousandths = الألف
Thrall = العبد
Thralldom = العبودية
Thralls = العبيد
Thrash = التهيّج
Thrashed = مجلود
Thrasher = الدرّاسة
Thrashers = الدرّاسات
Thrashes = يجلد
Thrashing = الضربة
Thrashings = الضربات
Thread = الخيط
Threadbare = رثّ
Threadbarely = بشكل رثّ
Threadbareness = الرّثاثة
Threaded = مخيّط
Threader = الإبرة
Threadier = خيطي
Threadiest = خيطي
Threading = التخييط
Threads = الخيوط
Thready = خيطي
Threat = التهديد
Threaten = هدّد
Threatened = مهدّد
Threatener = مُهدّد
Threatening = التهديد
Threateningly = بتهديد
Threatens = يهدّد
Threats = التهديدات
Three = ثلاثة
Three-phase = المرحلة ثلاثة
Three-pin = الدبّوس ثلاثة
Threefold = ثلاثة أضعاف
Threes = الثلاثات
Threescore = ستّون
Threesome = الثّلاثيّة
Threonine = ثريونين
Thresh = إدرس
Threshed = مدروس
Thresher = الدرّاسة
Threshers = الدرّاسات
Threshes = يدرس
Threshhold = عتبة
Threshing = الدراسة
Threshold = العتبة
Thresholds = العتبات
Threw = رمى
Thrice = ثلاث مرات
Thrift = التوفير
Thriftier = أكثر إقتصادا
Thriftiest = مقتصد
Thriftily = بشكل مقتصد
Thriftiness = الاقتصاد
Thriftlessly = بإسراف
Thrifts = التوفير
Thrifty = مقتصد
Thrill = الإثارة
Thrilled = مبتهج
Thriller = القصة المثيرة
Thrillers = القصص المثيرة
Thrilling = الإثارة
Thrillingly = بشكل مثير
Thrills = الإثارات
Thrips = التِّربْسة
Thrive = إزدهر
Thrived = مزدهر
Thriven = مزدهر
Thriver = مزدهر
Thrives = يزدهر
Thriving = الإزدهار
Thrivingly = بشكل مزدهر
Throat = الحنجرة
Throated = ذو حنجرة
Throatier = حنجري
Throatiest = حنجري
Throatily = يصدر من الحلق
Throatiness = الحلقية
Throating = يصدر من الحلق
Throats = الحناجر
Throaty = حنجري
Throb = الدقة
Throbbed = خافق
Throbber = نابض
Throbbing = الخفقان
Throbs = الدقات
Throe = الألم
Throes = الآلام
Thrombi = جلطات
Thrombose = يتخثّر
Thromboses = التخثّرات
Thrombosis = التخثّر
Thrombotic = تخثّري
Thrombus = جلطة
Throne = العرش
Throneberry = ثرونبري
Throned = اعترش
Thrones = العروش
Throng = الحشد
Thronged = متحشّد
Thronging = التحشّد
Throngs = الحشود
Throning = الإعتراش
Throstle = السمنة
Throstles = السمنات
Throttle = الصمام الخانق
Throttled = مخنوق
Throttler = خانِق
Throttles = الصمامات الخانقة
Throttling = الخنق
Through = خلال
Through-connection = خلال الإتّصال
Throughly = تماما
Throughout = في كافة أنحاء
Throughput = الطاقة الإنتاجية
Throve = إزدهر
Throw = الرمية
Throw-off = إرم
Throwaway = النشرة
Throwback = الإرتداد
Throwbacks = الإرتداد
Thrower = الرامي
Throwers = الرماة
Throwing = الرمي
Thrown = مرمي
Throws = الرميات
Thru = خلال
Thrum = الطنطنة
Thrummed = منقور
Thrumming = النقر
Thrums = الطنطنة
Thrush = الدجّ
Thrushes = الدجّ
Thrust = الدفع
Thruster = الصاروخ
Thrusters = الصواريخ
Thrusting = التّهجّم
Thrustings = التهجّمات
Thrusts = الدفعات
Thruway = طريق عريض
Thruways = طرق عريضة
Thu = الخميس
Thuban = النجم القطبي
Thud = الهدّة
Thudded = مرتطم
Thudding = الإرتطام
Thuds = الهدّات
Thug = السّفّاح
Thuggee = جريمة السّفّاح
Thugs = السّفّاحون
Thule = أقصى الشّمال
Thulium = الثُّليوم
Thumb = الإبهام
Thumbed = قلّب الصفحات
Thumbing = تقليب الصّفحات
Thumbnail = ظفر الإبهام
Thumbnails = أظافر الإبهام
Thumbs = أصابع الإبهام
Thumbscrew = القلاووظ الإبهامي
Thumbscrews = القلاويظ الإبهامية
Thumbtack = المُسيْمير الإبهامي
Thumbtacked = ثبّت بمُسيمير إبهاميّ
Thumbtacking = التثبيت بمُسيمير إبهاميّ
Thumbtacks = يثبّت بمُسيمير إبهاميّ
Thump = يجلد
Thumped = جلد
Thumper = ضارب
Thumpers = ضاربون
Thumping = الجلد
Thumps = الجلدات
Thunder = الرعد
Thunder-storm = الزوبعة الرعدية
Thunderbird = طائر الرّعد
Thunderbolt = الصاعقة
