Treble = ثلاث أضعاف
Trebled = مضاعف ثلاث مرات
Trebles = يضاعف ثلاث مرات
Trebling = مضاعفة ثلاث مرات
Trebly = بثلاث أضعاف
Tree = الشجرة
Treed = مشجّر
Treelike = كما الشجرة
Trees = الأشجار
Treetop = رأس الشجرة
Treetops = رؤوس الأشجار
Trefoil = البرسيم
Trefoils = الزينة
Trek = الرحلة
Trekked = مرتحل
Trekking = الإرتحال
Treks = الرحلات
Trellis = التعريشة
Trellised = متشابك
Trellises = التعريشات
Tremble = إرتجف
Trembled = مرتجف
Trembler = المرتجف
Trembles = يرتجف
Trembling = الإرتجاف
Tremblingly = بشكل مرتجف
Trembly = مرتجف
Tremendous = كبير
Tremendously = بشكل هائل
Tremendousness = العظمة
Tremor = الهزّة
Tremors = الهزّات
Tremulous = مرتجف
Tremulously = بشكل مرتجف
Tremulousness = الارتعاش، الخوف
Trench = الخندق
Trenchant = حادّ
Trenchantly = بشكل حادّ
Trenched = متخندق
Trencher = الصّينيّة
Trencherman = الأكول
Trenchermen = الأكولون
Trenchers = الصّواني
Trenches = الخنادق
Trenching = التخندق
Trend = الإتجاه
Trend-setting = مكان إتجاه
Trended = مميل
Trendier = أكثر عصريّة
Trendiest = أكثر عصريّة
Trendiness = مسايرة الموضة
Trending = الإمالة
Trends = الإتّجاهات
Trendy = عصري
Trenton = ترينتن
Trepanned = مغشوش
Trepans = المثاقب المنشارية
Trepidation = الهلع
Trepidations = الهلع
Trespass = الخطيئة
Trespassed = متجاوز
Trespasser = المتجاوز
Trespassers = المتجاوزن
Trespasses = التجاوزات
Trespassing = التجاوز
Tress = الخصلة
Tressed = مجدول
Tresses = الخصلات
Trestle = الحامل
Trestles = الحوامل
Trevelyan = تريفيليان - مؤرّخ إنجليزيّ
Tri-state = ثلاثي الحالة
Triable = عرضة للمحاكمة
Triableness = التعرّض للمسائلة القانونية
Triac = صمّام تحكّم كهربائي
Triad = مجموعة من ثلاثة
Triadic = ثلاثيّ
Triads = مجموعات من ثلاثة
Triage = الحَجْرْ - كما الحجر الصّحي
Trial = التجربة
Trial-and-error = التجربة والخطأ
Trials = التجارب
Triamcinolone = مضاد للإلتهابات
Triangle = المثلث
Triangles = المثلثات
Triangular = مثلثي
Triangularly = بشكل مثلثي
Triangulate = ثلّث
Triangulated = مثلّث
Triangulation = حساب وتحديد الاتّجاه
Triangulum = ترايانجلم - مجموعة نجوم شماليّة صغيرة
Trianon = فيلّا جميلة صغيرة
Triassic = خاص بالعصر التّرياسي
Triatomic = ثلاثيّ الذّرّات
Tribal = عشائري
Tribalism = القبليّة
Tribalisms = القبليّة
Tribally = بشكل عشائري
Tribe = القبيلة
Tribes = القبائل
Tribesman = رجل القبيلة
Tribesmen = رجال القبيلة
Tribulate = يمتحن
Tribulation = المحنة
Tribulations = المحن
Tribunal = المحكمة
Tribunals = المحاكم
Tribune = منبر الخطابة
Tribunes = منصات الخطابة
Tributaries = الروافد
Tributary = الرافد
Tribute = التقدير
Tributes = التقديرات
Tributing = يُثني على..
Trice = اللحظة
Triceps = ثلاثيّة الرّؤوس
Tricepses = ثلاثيّو الرّؤوس
Triceratops = ترايسيراتوبس - أحد الديناصورات
Trichinella = تريكينيلا - دودة خيطيّة طفيلية
Trichinosis = تريكينوسيس - مرض بسبب أكل اللّحم الغير مطهو جيّدًا
Trichloroacetic = حمض التريكلوروسيتيك
Trichloroethane = تريكلورويثان - سائل متطاير
Trichotomy = الانقسام الثّلاثيّ
Trichromatic = ثلاثيّ الألوان
Trichrome = ثلاثيّ الألوان
Trick = الخدعة
Tricked = مخدوع
Tricker = تريكير
Trickeries = الخدع
Trickery = الخداع
Trickier = أصعب
Trickiest = أصعب
Trickiness = الصّعوبة
Tricking = الخدع
Trickle = الوشل
Trickled = متقطّر
Trickles = يتقطّر
Trickling = التقطّر
Tricks = الخدع
Trickster = المحتال
Tricksters = المحتالون
Tricky = صعب
Tricolor = ثلاثي الألوان
Tricolored = ذو ثلاثة ألوان
Tricolors = الأعلام ثلاثية الألوان
Tricolour = ثلاثي الألوان
Tricot = الحياكة
Tricots = الحياكة
Tricycle = الدرّاجة الثلاثية
Tricycles = الدرّاجات الثلاثية
Trident = الرمح الثلاثي
Tridents = الرماح الثلاثية
Tridiagonal = تردياجونال
Tried = مجرّب
Triennial = واقع كلّ ثلاث سنوات
Triennially = كلّ ثلاث سنوات
Trier = المحاول
Triers = المحاولون
Tries = المحاولات
Trifle = كعكة الفاكهة
Trifled = عابث
Trifler = العابث
Trifles = كعكات الفاكهة
Trifling = العبث
Trifluoride = الفلوريد الذي يحتوي على ثلاثة ذرّات من الفلور
Trifoliate = ثلاثيّ الأوراق
Trig = أوقف
Trigamous = بثلاث أنواع من الأزهار
Trigged = رتّب
Trigger = الزناد
Triggered = مسبّب
Triggering = التسبّب
Triggers = النوابض
Trigging = الترتيب
Trigonal = بثلاث زوايا
Trigonally = ثلاثي التّماثل
Trigonometric = مثلثي
Trigonometrical = مثلثي
Trigonometrically = بشكل مثلثي
Trigonometry = علم المثلثات
Trigram = شكل ذو ثلاث خطوط متوازية
Trigrams = أشكال ذات ثلاث خطوط متوازية
Trigs = ينزلق
Trihedral = ثلاثيّ السّطوح
Trilateral = ثلاثي الأضلاع
Trilaterally = ثلاثيا
Trilingual = ثلاثي اللغة
Trill = التسجيع
Trilled = مردّد
Triller = المكرّر
Trilling = الترديد
Trillion = تريليون
Trillions = تريليونات
Trillionth = واحد من الترليون
Trills = التغريد
Trilobite = تريلوبيت - حيوان مفصلي منقرض
Trilogies = الثلاثيات
Trilogy = الثلاثية
Trim = الحالة
Trim-pot = القدر المرتّب
Trimble = تريمبل - سياسي من أيرلندا الشّماليّة
Trimer = أرتب
Trimester = الثلث
Trimesters = الأثلاث
Trimly = بشكل مرتّب
Trimmed = مشذّب
Trimmer = المتقلب
Trimmest = الأكثر تهذيباً
Trimming = التشذيب
Trimmings = الزركشة
Trimness = التّزيين
Trims = الحالات
Trinidad = ترنيداد
Trinitarian = مؤمن بالثّالوث
Trinitarianism = الثالوثية
Trinitarians = المؤمنون بالثّالوث
Trinitrotoluene = ثالث نتريت التولوين
Trinity = الثالوث
Trinket = الحلية الرخيصة
Trinketer = تاجر الحلي
Trinkets = الحلي الرخيصة
Trinomial = ثلاثيّ الحدود
Trinomials = ثلاثيّ الحدود
Trio = الثلاثي
Triode = الصمام الثلاثي
Triodes = الصمامات الثلاثية
Trios = الثلاثيون
Trioxide = أكسيد بثلاث ذرّات
Trip = السفرة
Trip-Hop = قفزة رحلة
Tripartite = ثلاثي
Tripartition = الانقسام الثّلاثيّ
Tripe = تريب
Triphosphopyridine = البيريداين بثلاثة مجموعات فوسفور
Triple = ثلاث أضعاف
Tripled = متضاعف ثلاث مرات
Triples = يتضاعف ثلاث مرات
Triplet = أحد توأم ثلاثة
Triplets = توأم ثلاثة
Triplett = تريبليت
Triplex = ثلاثي
Triplicate = من ثلاث نسخ
Triplicated = مثلّث
Triplicates = يثلّث
Triplicating = التثليث
Triplication = مضاعفة ثلاث المرّات
Tripling = تضاعف ثلاث مرات
Triply = بشكل رحلة
Tripod = الحامل الثلاثي
Tripodal = ثلاثيّ القوائم
Tripods = الحاملات الثلاثية
Tripoli = طرابلس
Tripolyphosphate = ترايبوليفوسفيت
Tripped = متعثّر
Tripper = المتنزه
Trippers = المتنزهون
Trippet = عمود الكامة
Tripping = التعثّر
Trippingly = على نحو خفيف سلس
Trips = السفرات
Triptych = لوح ثلاثي
Triptychs = ألواح ثلاثيّة
Trireme = السّفينة
Triremes = السّفن
Trisect = ثلّث
Trisected = مثلّث
Trisecting = التثليث
Trisection = مقطع ثلاثي، ثلاث مقاطع
Trisects = يثلّث
Trisodium = الاحتواء على ثلاثة ذرّات صوديوم
Tristan =  تريستان - ابن أخ مارك الملك . أساطير العصور الوسطى
Tristate = خاصّ بثلاث ولايات
Trisyllabic = ثلاثيّ المقاطع
Trisyllable = كلمة ثلاثيّة المقاطع
Trite = تافه
Tritely = بشكل تافه
Triteness = الابتذال
Triter = تافه
Tritest = تافه
Tritium = التريتيوم - نظير مشع
Triton = التريتون
Triturate = إطحن
Triturated = مطحون
Triturates = يطحن
Triturating = الطحن
Triumph = الإنتصار
Triumphal = منتصر
Triumphant = منتصر
Triumphantly = بانتصار
Triumphed = منتصر
Triumphing = الإنتصار
Triumphs = الإنتصارات
Triumvir = عضو الحكومة الثّلاثيّة
Triumvirate = حكومة الثلاثة
Triumvirates = حكومات الثلاثة
Triumvirs = أعضاء الحكومة الثّلاثيّة
Triune = ثالوثي
Trivalent = ثلاثيّ التّكافؤ
Trivet = الركيزة
Trivets = الركائز
