Wrinkling = التّجعّد
Wrinkly = العجوز
Wrist = المعصم
Wristband = الإسورة
Wristbands = الأساور
Wristlet = السّوار - ما يلبس حول المعصم من زينة
Wrists = المعاصم
Wristwatch = السّاعة
Wristwatches = ساعات اليد
Writ = الوثيقة
Writability = القدرة على الكتابة
Writable = مناسب للكتابة
Write = اكتب
Write-down = التّخفيض من قيمة السّلعة
Write-enable = اكتب يمكّن
Write-off = دين لايمكن تحصيله
Write-only = اكتب فقط
Write-protect = اكتب يحمي
Write-protected = اكتب محميّ
Write-read = اكتب القراءة
Writeable = قابل للكتابة
Writer = الكاتب
Writers = الكتّاب
Writes = يكتب
Writeup = التّقرير
Writhe = تلوّ
Writhed = تلوّى
Writhes = يتلوّى
Writhing = التّلوّي
Writing = المكتوب
Writing-reading = الكتابة - القراءة
Writings = المؤلّفات
Writs = الوثائق
Written = كتب
Wrong = الخطأ
Wrong-doing = الإثم، التصرّف المشين
Wrongdoer = الآثم
Wrongdoers = الآثمون
Wrongdoing = الإثم
Wrongdoings = الآثام
Wronged = ظلم
Wronger = خطأ
Wrongest = الخطأ
Wrongful = ظالم
Wrongfully = بصورة غير شرعيّة
Wrongfulness = الضّلال
Wronging = الظّلم
Wrongly = بطريقة خاطئة
Wrongness = الخطأ
Wrongous = بطريق الخطأ
Wrongs = الأخطاء
Wronskian = رونسكايان
Wrote = كتب
Wroth = ثائربشدّة واستنكاريّ
Wrought = مصنوع
Wroughtiron = الحديد المطاوع
Wrt = فيما يخصّ، بخصوص
Wrung = عصر
Wry = ممتعض
Wryly = بامتعاض
Wryneck = اللواء
Wrynecks = اللواء
Wryness = الالتواء
Wsw = بين الغرب والجنوب الغربي
Wu = وو - لهجة صينيّة
Wuhan = ووهان
Wulfenite = عنصر الولفنيت
Wumpus = وومبس - لعبة من ألعاب الكمبيوتر
WV = فرجينيا الغربيه
WWW = الشبكة العالميّة
Wwww = أول محرّك بحث في العالم. أنتجته جامعة كولورادو عام 1994
WY = وايومينج
Wyandot = قبيلة وياندوت الهندية التي قطنت ولاية أوهايو
Wyandotte = الوايندوتية
Wyatt = ويات
Wyd = عريض، واسع
Wye = الحرف الإنجليزي واي
Wyes = الحروف الإنجليزية واي
Wyeth = وِيِثْ
Wylie = ويلي
Wyman = ويمان
Wynd = حارة ضيّقة أو زقاق
Wyner = وينر
Wynn = وين
Wynne = مدينة وين
Wynot = مدينة وينوت
Wyoming = وايومينج
Wype = طائر الوايب
Wysiayg = الذي تراه هو كل ما يمكنك الحصول عليه
Wysiwyg = عندما تقوم بعمليّة الطّباعة فإنّك ستحصل على الذي تراه على الشّاشة
Wythe = غصن الشّجرة
Wyvern = تنّين نافث للّهب
X = أكس - الحرف الرابع والعشرون في اللغة الإنجليزية
X-axis = المحور السّيني او الأفقي
X-coordinate = الإحداثي السّيني
X-Factor = معامل س
X-mas = أعياد الميلاد المسيحيّة
X-Position = موضع س
X-ray = الأشعة السّينيّة / أشعّة أكس
X-rays = يصوّر عن طريق أشعة أكس
X-Server = خادم إكس
X-Title = عنوان س
X-windows = نظام نوافذ لأنظمة تشغيل يونكس. إبتدعته جامعة أم آي تي
X25 = نظام للإتصالات
Xanax = زاناكس - دواء مضادّ للقلق
Xanthate = ملح الزنتات
Xanthelasma = داء يصيب جفون العين خاصّة لدى كبار السّن
Xanthic = حمض الزّانتك
Xantho- = أصفر
Xanthochroid = الشّخص الذي يملك بشرة فاتحة و الشّعر الخفيف
Xanthoma = زانثوما - مرض جلدي
Xanthophyl = صبغة صفراء في النّباتات و الدّهون الحيوانيّة و أمحاح البيض
Xanthophyll = صبغة صفراء في النّباتات و الدّهون الحيوانيّة و أمحاح البيض
Xanthosis = تغيّر لون الجلد الى الأصفر الغير طبيعي
Xanthus = زانثس
Xavier = خافير
Xaw = قطع أثينا لنظام أكس للنوافذ
Xbase = اللقب العام لبرامج قواعد البيانات
Xc = اختراق الضّاحية
Xe = غاز الزينون. غاز خامل
Xebec = قارب ذو ثلاث صواري
Xeme = النّورس القطبيّ الشّماليّ
Xenia = زينيا
Xenium = الهديّة
Xenix = زينويكس
Xenodochium = بيت مخصص للضيوف
Xenodochy = ضيافة الغرباء
Xenogenesis = إنتاج سّلالة مختلفة عن الآباء
Xenomania = الهوس، الحبّ أكثر ممّا ينبغي
Xenon = الإكسينون
Xenophobia = كره الأجانب
Xenophobic = كاره للأجانب
Xenopus = الضّفدع الإفريقيّ ذو المخلب
Xenyl = الميزة الراديكاليّة لمركبّات زينويليك
Xeres = خمر أسبانيّ
Xeric = قاحل، جاف
Xerif = الشريف، النّبيل
Xerographic = متعلّق بالتّصوير الجافّ
Xerography = التّصوير الجافّ
Xerophagy = صوم عند المسيحيّين
Xerophile = نبات الزيروفيل
Xerophilous = النّبات الذي يزدهر في موطن الجاف
Xerophyllum = أعشاب الزيروفيللم
Xerophyte =  النّبات الصّحراوي، النّبات الذي لايحتاج لكثير من الماء
Xerophytic = يصلح للبيئة الصّحراوية الجّافّة
Xerox = النّسخة
Xeroxed = نسخ
Xeroxes = النّسخ
Xeroxing = النّسخ
Xerus = زيرس - حيوان أفريقي كما السّنجاب
Xerxes = زركسيس
Xhosa = لغة الزوشا المستعملة في جنوب أفريقيا
Xi = الحرف الرّابع عشر للأبجدية اليونانيّة
Xian = مدينة زيان الصّينية
Xii = إثنا عشر
Xiii = ثلاثة عشر
Ximian = زيميان
Xinerama = زينيراما
Xiphias = نوع من أنواع سمك ابو سيف
Xiphisternum = الجزء المنخفض لعظمة الصّدر
Xiphoid = على شكل السيف
Xiv = أربعة عشر
Xix = تسعة عشر
Xl = مقاس كبير جدّاً
Xlib = مكتبّية لنظام أكس
Xmas = عيد الميلاد
Xml = أكس أم أل - نظام متّفق عليه لتشكيل النّصوص
Xmm = نظام إدارة ذاكرة الكومبيوتر الموسّع
Xmodem = إكس مودم
Xor = أكس أور - عامل منطقي
Xpm = ملفّ لشكل من أشكال الصّورة
Xray = الأشعة السّينيّة / أشعّة أكس
Xrays = الأشعّات السّينيّة
Xref = التّأكيد على المعلومة بالإطّلاع على مراجع أُخرى
XSession = جلسة
Xt = إختصار لكلمة السيد المسيح
XTerm = إكس تيرم
Xtran = لغة برمجيّة مثل لغة فورتران
Xui =  واجهة المستخدم في نظام X للنّوافذ
Xv = خمسة عشر
Xvi = ستة عشر
Xvii = سبعة عشر
Xviii = ثمانية عشر
Xx = عشرون
Xxi = 21
Xxii = 22
Xxiii = 23
Xxiv = 24
Xxix = 29
Xxv = 25
Xxvi = 26
Xxvii = 27
Xxviii = 28
Xxx = 30
Xylan =  الزيلان - مادّة نّباتية لزجة صفراء
Xylem = الزيليم
Xylene = الزيلين
Xylenol = زيلينول
Xylo- = كلمة سابقة وتعني الخشب
Xylocaine = زيلوكين - ماركة تجاريّة لمخدّر موضعي
Xylocopine = زيلوكوباين - نوع من الحشرات
Xylogen = الخشب النّاشئ
Xylograph = نقش على خشب
Xylography = التلوين على الخشب
Xyloid = مشابهة الخشب / يمتلك طبيعة الخشب
Xylol = الزيلين - سائل متطاير قابل للاشتعال عديم اللّون
Xylology = فرع لعلم الشّجر يتناول الهيكل الدّقيق للخشب
Xylomelum = شجيرة الزيلوميلم الإستراليّة
Xylophaga = حيوان رخوي بحري
Xylophagous = آكل الخشب
Xylophilan = زيلوفيلان - نوع من أنواع الخنافس التي تعيش على أكل الأخشاب
Xylophili = زيلوفيلان - نوع من أنواع الخنافس التي تعيش على أكل الأخشاب
Xylophilous = العيش على أو في الخشب
Xylophone = الاكسليفون
Xylophones = الاكسليفون
Xylophonist = الذي يلعب آلة الاكسليفون
Xylose = سكّر الزيلوز
Xylotomous = قادر على قطع الخشب
Xylotomy = تجهيز شرائح الخشب للدّراسة الدّقيقة
Xyphophorus = سمكة الذيل أبو سيف
Xyst = مكان مغطّى للتّمارين الرّياضيّة
Xyster = أداة لكشط العظام
Xystus = مكان مغطّى للتّمارين الرّياضيّة
Y = واي - الحرف الخامس والعشرون في اللغة الإنجليزية
Y- = بادئة معنى مجهول. أصلاً استخدمت للأفعال، الظّروف، الصّفات، الأسماء و الضّمائر
Y-axis = المحور الصّاديّ، العمودي
Y-branch = الفرع ص
Y-coordinate = المحور الصّادي
Y-Factor = معامل ص
Y-Position = موقع ص
Y-Title = عنوان ص
Y2k = السنة 2000
Ya = البالغ الصّغير
Yacare = ياكير - تمساح جنوب أمريكيّ
Yacc = ياكّ
Yacht = اليخت
Yachter = صاحب اليخت
Yachters = أصحاب اليخت
Yachting = الإبحار باليخت
Yachts = اليخوت
Yachtsman = مالك اليخت
Yachtsmen = ملّاك اليخوت
Yachtswoman = مالكة اليخت
Yack = الثرثرة
Yacolt = مدينة ياكولت
Yaffle = يافل - نقّار الخشب الإنجليزي ذو اللون الأخضر
Yager = ييدجر
Yagi = ياجي - هوائي موجّه
Yah = نعم
Yahoo = متوحّش ذو شكل بشري
Yahoos = متوحّشون ذوي أشكال بشريّة
Yahveh = اسم اللّه بالعبريّة
Yahwe = اسم اللّه بالعبريّة
Yahweh = اسم اللّه بالعبريّة
Yak = الثّور
Yakima = ياكيما
Yakin = ياكين - ظبي آسيويّ كبير
Yakked = ثرثر
Yakking = الثّرثرة
Yaks = الثّيران
Yakut = لغة الـ ياكت
Yale = ييل
Yalta = يالتا
Yaltopya = أثيوبيا
Yalu = نهر اليالو
Yam = النّبات المتسلّق
Yama = ياما - إله عالم الجريمة
Yamaha = ياماها
Yamen = المقر الرئيسي لأحد رسميي الحكومة الصينية
Yammer = ثرثر
Yammered = ثرثر
Yammering = الثّرثرة
Yammers = يثرثر
Yamp = نبات اليامب
Yams = النّباتات المتسلّقة
Yancey = مقاطعة يانسي
Yang = الفحولة
Yangon = يانجون - المدينة الكبيرة و عاصمة ميانمار
Yangtze = نهر اليانجتز
Yank = الأمريكيّ
Yanked = انتزع
Yankee = الأمريكيّ
Yankee-doodle = الأمريكي
Yankees = أمريكيون
Yanking = الانتزاع
Yanks = الأمريكيّون
Yankton = يانكتون
Yaounde = ياوندي
Yaourt = مشروب الياورت التّركي
Yap = النّباح
Yapock = حيوان الأوبوسوم المائيّ الجنوب أمريكيّ
Yapon = نبات اليابون
Yapped = نبح
Yapping = النّبح
Yaps = النّباح
Yaqui = ياكي
Yarage = قوّة التّحرّك في البحر
Yard = السّاحة
Yardage = الحجم
Yardarm = نهاية او طرف الصّارية
