Buchenwald = بتشينوالد
Buchwald = بتشوالد
Buck = الدّولار
Buckaroo = راعي البقر
Buckaroos = رعاة البقر
Buckboard = الحنطور
Buckboards = الحناطير
Bucked = قفز
Bucker = بكر
Bucket = الجردل
Bucketed = بكيتيد
Bucketful = ملء الدّلو
Bucketfull = بكيتفل
Bucketfuls = ملء الدّلو
Bucketing = المضاربة
Buckets = الجرادل
Buckeye = بك آي - أسم يطلق على مجموعة من اﻷشجار اﻷمريكية
Buckhorn = قرن ذكر الحيوان
Bucking = القفز
Buckle = الإبزيم
Buckled = التوى
Buckler = التّرس
Bucklers = التّروس
Buckles = الأبازيم
Buckley = بكلي
Buckling = التواء
Bucknell = بَكْنِلْ
Bucks = الدّولارات
Buckshot = الرّصاص
Buckskin = الجلد
Buckskins = الجلود
Buckthorn = النّبق
Buckwheat = القمح
Buckwheats = القمح
Bucky = بوكي
Bucolic = ريفيّ
Bucolically = بطريقة ريفيّة
Bud = البرعم
Budapest = بودابست
Budd = بد
Budded = أزهر
Buddha = بوذا
Buddhism = البوذيّة
Buddhist = البوذيّ
Buddhists = البوذيّون
Buddies = الأصدقاء
Budding = الإزهار
Buddy = الصّديق
Budge = تزحزح
Budged = تزحزح
Budgerigar = الببّغاء
Budges = يتزحزح
Budget = الميزانيّة
Budgetary = متعلّق بالميزانيّة
Budgeted = وضع ميزانيّة
Budgeter = معدّ الميزانيّة
Budgeters = معدّون الميزانيّة
Budgeting = وضع ميزانيّة
Budgets = الميزانيّات
Budgie = الببّغاء
Budgies = الببّغاء
Budging = التّزحزح
Buds = البراعم
Budweiser = بدويايزر
Buehring = بويرنج
Buena = بْوينا
Buff = الهاوي
Buffalo = الجاموسة
Buffaloes = الجاموسات
Buffalos = الجاموسات
Buffed = لمّع
Buffer = الواقٍ
Buffer-bar = بار الدّولة المحايدة
Buffered = خفّف
Buffering = التّخفيف
Buffers = الواقونً
Buffet = البوفيه
Buffeted = لطم
Buffeting = اللّطم
Buffetings = الصراع
Buffets = البوفيهات
Buffing = التّلميع
Bufflehead = الزغباء الرأس
Buffoon = المهرّج
Buffooneries = التهريج
Buffoonery = التّهريج
Buffoons = المهرّجون
Buffs = الهواة
Bug = البقّة
Bugaboo = الشّيء المخيف
Bugatti = بجاتي
Bugbear = الهمّ
Bugbears = الهموم
Bugeyed = جاحظ
Bugged = ضايق
Bugger = التّافه
Buggered = متعب
Buggering = اللواط
Buggers = التّافهون
Buggery = اللواط
Buggier = كثير الأخطاء
Buggies = العربات
Bugginess = حالة اﻷمتلاء بالبق
Bugging = المضايقة
Buggy = العربة
Bugle = البوق
Bugled = مبوّق
Bugler = عازف البوق
Buglers = عازفون البوق
Bugles = الأبواق
Bugling = التبوّق
Bugs = البقّ
Buick = بيوك
Build = ابن
Build-host = ابن المضيف
Build-time = ابن الوقت
Builded = بنى (العمارة، البنيان)
Builder = البنّاء
Builders = البنّاءون
Building = المبنى
Buildings = المباني
Builds = البنى
Buildup = التّعزيز
Buildups = التّعزيزات
Built = بنى
Built-in = مدمج
Built-up = مكتظّ بالمباني
Builtin = مدمج
Bujumbura = بوجمبورا
Bulb = اللّمبة
Bulbed = يحتوي على مصباح
Bulblet = مصباح صغير
Bulbous = منتفخ
Bulbs = اللّمبات
Bulgaria = بلغاريا
Bulgarian = البلغاريّ
Bulge = الانتفاخ
Bulged = انتفخ
Bulges = الانتفاخات
Bulging = الانتفاخ
Bulgy = منتفخ
Bulk = المعظم
Bulked = متضخّم
Bulkhead = الحاجز
Bulkheads = الحواجز
Bulkier = أضخم
Bulkiest = الأضخم
Bulkily = بضخامة
Bulkiness = الضّخامة
Bulks = المعظم
Bulky = ضخم
Bull = الثّور
Bulldog = البلدغ
Bulldogs = البلدغ
Bulldoze = اهدم
Bulldozed = هدم
Bulldozer = البلدوزر
Bulldozers = البلدوزرات
Bulldozes = يهدم
Bulldozing = الهدم
Bulled = شقّ
Bullet = الرّصاصة
Bulletin = النّشرة
Bulletins = النّشرات
Bulletproof = ضدّ الرّصاص
Bulletproofed = جعل مضادًّا للرّصاص
Bulletproofing = جعل مضادًّا للرّصاص
Bulletproofs = يجعل مضادًّا للرّصاص
Bullets = الرّصاص
BulletsNumbers = بليتسنمبيرز
Bullfight = مصارعة الثّيران
Bullfighter = مصارع الثّيران
Bullfighting = مصارعة الثّيران
Bullfights = مصارعات الثّيران
Bullfinch = البولفينش
Bullfrog = الضّفدع
Bullfrogs = الضّفادع
Bullhead = السمك البلهد
Bullheaded = عنيد
Bullheadedly = بعناد
Bullheadedness = العناد
Bullheads = السمك البلهد
Bullied = أرهب
Bullies = الفتوّات
Bulling = الشّقّ
Bullion = السّبائك
Bullions = السبائك
Bullish = متفائل
Bullishly = باطمئنان
Bullishness = الاطمئنان
Bullnecked = غليظ الرّقبة
Bullock = العجل
Bullocks = العجول
Bullring = الحلبة
Bullrings = الحلبات
Bulls = الثّيران
Bullseye = نقطة الهدف
Bullshit = الهراء
Bullwhip = السّوط
Bullwhips = السياط الكبيرة
Bully = الفتوّة
Bullyboy = العنيف
Bullyboys = البلطجيّون
Bullying = الإرهاب
Bulrush = عشب البرك
Bulrushes = عشب البرك
Bulwark = الواقٍ
Bulwarks = الواقياتٌ
Bum = المتشرّد
Bumble = تلعثم
Bumblebee = النّحلة
Bumblebees = النّحل
Bumbled = تلعثم
Bumbledom = التلعثم
Bumbler = المتردّد
Bumblers = المتردّدون
Bumbles = يتلعثم
Bumbling = التّلعثم
Bumblingly = بشكل طنّان
Bummed = طلب
Bummer = المشكلة
Bummers = المشكلات
Bumming = الطّلب
Bump = اهتززت
Bumped = اهتزّ
Bumper = ممتصّ الصّدمة
Bumpers = ممتصّات الصّدمة
Bumpier = أكثر وعورة
Bumpily = بشكل وعر
Bumpiness = الوعورة
Bumping = الاهتزاز
Bumpkin = المتخلّف
Bumpkins = المتخلّفون
Bumps = لكدمات
Bumptious = مغرور
Bumptiously = بغرور
Bumptiousness = الغرور
Bumpy = وعر
Bums = المتشرّدون
Bun = الكعكة
Bunch = المجموعة
Bunched = اجتمع
Bunches = المجموعات
Bunching = الاجتماع
Bundestag = بنديستاج
Bundle = الحزمة
Bundled = أسرع
Bundles = الحزم
Bundling = الإسراع
Bundy = بندي
Bungalow = المنزل
Bungalows = المنازل
Bungle = الفشل
Bungled = أفسد
Bungler = الغبيّ
Bunglers = الأغبياء
Bungles = الفشل
Bungling = الفشل
Bunglingly = بشكل مفسد
Bunion = الورم
Bunions = الأورام
Bunk = السّرير
Bunked = نام
Bunker = مستودع الفحم
Bunkered = زوّد بوقود
Bunkering = بنكيرينج
Bunkers = مستودعات الفحم
Bunkhouse = الاستراحة
Bunkhouses = الاستراحات
Bunking = النّوم
Bunkmate = مُشاطر مكان النوم
Bunkmates = مشاطروا مكان النوم
Bunks = الأسرّة
Bunnies = الأرانب
Bunny = الأرنب
Buns = الكعك
Bunsen = بنسن
Bunt = الضّربة
Bunted = ألقى
Bunter = متعلق بالعصر الترياسي
Bunting = الرّايات
Bunts = الضّربات
Bunyan = بَنْيان
Buoy = العوّامة
Buoyancy = الطّفو
Buoyant = متفائل
Buoyantly = بانشراح
Buoyed = ساند
Buoying = المساندة
Buoys = العوّامات
Bur = الأزيز
Burbank = بربانك
Burble = التّمتمة
Burbled = هذى
Burbler = متمتم
Burbles = يهذي
Burbling = البقبقة
Burch = بورتش
Burden = المسئوليّة
Burdened = أرهق
