Actin = شعاع، أشعة
Actinal = شعاعي
Acting = العمل
Actinia = شُقَّار، شقائق النعمان وأشباهها
Actiniae = شُقَّار، شقائق النعمان وأشباهها
Actinic = أكتيني
Actinide = أكتينايد
Actinidia = الأكتينيديا (كرمة آسيوية خشبية صغيرة)
Actinism = الأكتينيّة (قدرة في الطاقة المشعة على إحداث التغييرات الكيميائية)
Actinium = الأكتينيوم
Actinolite = أكتينولايت
Actinometer = مقياس قوة أشعة الشمس
Actinometers = مقاييس قوة أشعة الشمس
Actinomyces = الحارش (طفيلي بكتيري)
Actinomycetales = بكتيريا خُييطية
Actinomycete = بكتيريا من نوع الخُييطية
Actinomycetes = بكتيريا من نوع الخُييطية
Actinomycin = أكتينوميسين (مضاد حيوي)
Actinomycosis = مرض الحارش
Actinotherapy = العلاج بالإشعاع
Action = العمل
Actionable = موجب لإقامة دعوى قضائيّة
Actions = الأفعال
Actis = مشعّ
Actium = معركة أكتيوم البحرية
Activatable = قابل للنتشيط
Activate = نشّط
Activated = نشّط
Activates = ينشّط
Activating = التّنشيط
Activation = التّنشيط
Activations = التّنشيط
Activator = المنشّط
Activators = المنشّطات
Active = الصّيغة المعلوم
Actively = بنشاط
Activeness = الفعاليّة
Activex = أكتف إكس
Activism = الفعّاليّة
Activisms = النشاط
Activist = النّاشط
Activistic = ناشط، فعّالي
Activists = النّاشطون
Activities = الأنشطة
Activity = النّشاط
Actomyosin = ميوسين مشعّ
Acton = أكتون
Actor = الممثّل
Actors = الممثّلون
Actress = الممثّلة
Actresses = الممثّلات
Acts = الأعمال
Actual = فعليّ
Actualisation = التّحقيق
Actualist = تحقيقيّ
Actualities = الحقائق
Actuality = الحقيقة
Actualization = الإدراك
Actualizations = التحقيقات
Actualize = حقّق
Actualized = حقّق
Actualizes = يحقّق
Actualizing = التّحقيق
Actually = في الحقيقة
Actuals = الحقيقيّات
Actuarial = متعلّق بحسابات التّأمين
Actuarially = من ناحية الحسابات التّأمينيّة
Actuaries = خبراء التّأمين
Actuary = الخبير بشؤون التأمين
Actuate = شغّل
Actuated = شغّل
Actuates = يشغّل
Actuating = التّشغيل
Actuation = التّنفيذ
Actuator = المحرّك
Actuators = المحرّكات
Acture = العمل
Acturience = الرغبة في العمل
Actus = مَوْقِف، أكتس (مقياس روماني)
Acuate = يجعله حادّ، يشحذ، يبري
Acuation = الشّحذ، السّن
Acuities = البراعة
Acuition = الشّحذ، السّن
Acuity = البراعة
Acular = أكيولار (الاسم التجاري لدواء مثبّط)
Aculeata = شوائك، لوادغ
Aculeate = شائك، شوكي، لادغ
Aculei = رؤوس مدبّبة (نحل مثلاً)
Aculeus = رأس مدبّبة (رأس النحلة مثلا)
Acumen = الذّكاء، الفطنة
Acuminate = مستدِقّ الطرف (كورقة النبات)، حادّ
Acumination = ذو الطرف الحادّ
Acupressure = العلاج بالإبر
Acupuncture = علاج بالإبر
Acupunctures = الوخز بالأبر
Acushnet = أكيوشنيت
Acute = حادّ، قاسي، شديد
Acute-angled = حاد الزاوية
Acutely = بشدّة
Acuteness = الحدّة
Acutenesses = الحدّة
Acuter = أشدّ
Acutest = الأشدّ
Acyclic = أسيكليك
Acyclically = أسيكليكالي
Acyclovir = أسيكلوفر (مضاد للفيروس)
Acyl = أسيل
Ad = الإعلان
Ad hoc = خاصّ
Ad- = مقارب، شبيه
Ad-lib = عفوي، ارتجالي
Ada = أدا
Ada-o = تفرّع من لغة أدا
Adabas = أداباس (قاعدة بيانات علائقية)
Adact = يقود، يجبر
Adad = أداد (إله الطقس عند البابليين)
Adage = المثل
Adages = الأمثال
Adagio = المقطوعة الموسيقيّة
Adagios = المقطوعات الموسيقيّة
Adah = أداه
Adair = أدير
Adaline = الخلايا العصبية الطولية التكيّفية
Adam = آدم
Adamance = غير مرن، صعب التعديل
Adamant = عنيد
Adamantean = أدمَنْتيّ
Adamantine = صلب
Adamantly = بعناد
Adami = آدميّ، بشريّ، رجل
Adamic = آدميّ، من آدم
Adamite = من سلالة آدم
Adamo = أدامو (نظام إدارة بيانات)
Adams = أبناء آدم
Adamson = آدامسون
Adance = يرقص
Adapa = البابلية :: بابليّ :: مُترَف
Adapt = كيّف
Adaptability = التّكيّف
Adaptable = متكيّف
Adaptation = التّحويل
Adaptational = تحويليّ
Adaptationally = بشكل تحويليّ
Adaptations = التّحويلات
Adaptative = تكيّفي
Adapted = كيّف
Adaptedness = التكيّف
Adapter = المحوّل
Adapters = المحوّلات
Adapting = التّكييف
Adaption = التّأقلم
Adaptive = تكيّفيّ
Adaptively = بتكيّف
Adaptiveness = التكيّف
Adaptivenesses = التكيّفات
Adaptor = المحوّل
Adaptors = المحوّلات
Adapts = يكيّف
Adar = آذار، مارس
Adatis = قماش قطني هندي
Adaw = يُفزِع، يوقظ
Adaxial = مجاور محور العضو
Aday = أداي
Adc = المحوّل من الموجات الأحادية إلى الرقميّة
Adccp = بروتوكول التحكّم المتقدّم بالاتصالات البيانية
Add = أضف
Add-on = الملحق
AddNewPage = أضف صفحة جديدة
AddSet = اضافةضبط
Addax = المهاة (بقرة وحش كبيرة)
Addd = مستودع الوثائق التطويريّة
Added = إضافيّ
Addend = المضاف
Addenda = الإضافات
Addendum = الإضافة
Adder = الأفعى
Adders = الأفاعي
Addi = مساعد مدير المنطقة للتحقيقات
Addibility = إمكانيّة الجمع
Addict = المدمن
Addicted = جعل مدمنًا
Addictedness = الإدمان، التكرّس
Addicting = جعل مدمنًا
Addiction = الإدمان
Addictions = الإدمان
Addictive = مسبّب الإدمان
Addictively = بادمان
Addictiveness = الإدمان
Addicts = المدمنون
Adding = الإضافة
Addis = أديس
Addison = إديسون
Additament = مُضاف، مجموع
Addition = الإضافة
Additional = إضافيّ
Additionally = بالإضافة لذلك
Additions = الإضافات
Additive = الإضافة
Additively = بإضافة
Additives = الإضافات
Additivity = قابلية الجمع
Addle = شوّش
Addle-pate = شخص فاسد
Addle-pated = غبيّ
Addlebrained = غبيّ ومُرتبك
Addled = فاسد
Addlepate = شخص فاسد
Addlepated = غبيّ
Addles = يشوّش
Addling = التّشويش
Addorsed = موضوع ظهر لظهر (كالشعارات)
Address = العنوان
Addressability = قابلية العنونة
Addressable = قابل للتّخاطب
Addressbook = دفتر العناوين
Addressed = خاطب
Addressee = مرسل إليه
Addressees = مرسلون إليه
Addresser = المعنون
Addressers = المعنونون
Addresses = العناوين
Addressing = المخاطبة
Addressless = بلا عنوان
Addressograph = ماكنة العناوين
Adds = يضيف
Adduce = قدّم
Adduced = قدّم
Adducent = مقرِّب، مقرِّب نحو المحور
Adducer = أدسير
Adduces = يقدّم
Adducible = ممكن تقريبه
Adducing = التّقديم
Adduct = قرّب
Adducted = قرّب
Adducting = التّقريب
Adduction = التّقريب
Adductive = أدكتايف
Adductor = المقرّب
Adducts = يقرّب
Addy = عنوان
Ade = مشروب فواكه محلّى مخفف
Adeem = يُبطِل
Adel = نبيل من أصل شهير
Adelaide = أديليد
Adele = أديل
Adelia = أديليا
Adelie = بطاريق متوسطة الحجم
Adeline = أديلين
Adell = أدلّ
Adelphi = أدلفي
Adelphia = أخوّة
Adempt = يُبعِد
Ademption = إبعاد
Aden = عدن
Aden- = غدّة
Adena = أدينا
Adenine = أديناين
Adenitis = إلتهاب
Adeno = غدّة
Adeno- = غدّة
Adenocarcinoma = أدينوكارسينوما (مرض خبيث ينشأ من نسيج الغدة)
Adenoid = ليمفاويّ
Adenoidal = غددي
Adenoids = اللّحميّة
Adenoma = الورم الحميد
Adenomatous = وَرَمِيْغُدِّي :: متعلّق بورم غدِّي
Adenopathy = تضخّم الغدّة اللمفاوية
Adenose = يحتوي على غدد :: متعلق بالغدد :: يشبه الغدد
Adenosine = الأدينوساين
Adeps = دهن حيواني :: شحم خنزير
Adept = الخبير
Adeptly = ببراعة
Adeptness = المهارة
Adepts = الخبراء
Adequacies = الكفاءات
Adequacy = الكفاءة
Adequate = كافي
Adequately = على نحو كافي
Adequateness = الكفاية
Adequation = الكفاية :: الملائمة
Adfected = متأثّر :: مصاب
Adfiliated = دمج :: انضمّ :: انتسب
Adh = الهرمون المضاد لإدرار البول
Adhamant = متعلّق بـ :: متمسّك بـ
Adhere = التصق :: تماسك :: يخلص الولاء
Adhered = التصق :: أخلص بالولاء :: تماسك
Adherence = التزام :: الإلتصاق :: الإخلاص بالولاء
Adherent = المؤيّد :: تابع :: نصير :: ملتحق :: ملتصق
Adherently = بشكل متمسّك :: بشكل تابع :: بصورة مؤيدة
Adherents = المؤيّدون :: شِيعة :: أتباع
Adherer = مؤيّد :: النصير :: التابع
Adheres = يلتصق :: يناصر :: يؤيّد
Adhering = التصاق :: التأييد :: النّصرة
Adhesion = التصاق :: التحام :: تلاصق :: موالاة
Adhesions = التصاق :: التحام :: تلاصق :: موالاة
Adhesive = الصّمغ :: دبق :: لاصق :: لزج
Adhesively = بشكل لاصق :: بشكل دبق
Adhesiveness = الإلتصاق :: لزوجة
Adhesives = الصّمغ :: المواد اللاصقة :: المواد اللزجة
Adhocracy = عكس البيروقراطية :: بلا هرمية وظيفية :: الكل بمقدوره إتّخاذ قرار
