Contralto = كونترالتو
Contraption = البدعة
Contraptions = البدع
Contrapuntal = مختص
Contrapuntally = بشكل مختص
Contraries = النقائض
Contrariety = التناقض
Contrarily = بالعكس
Contrariness = المعارضة
Contrariwise = عكسيا
Contrary = مضاد
Contrast = المقارنة
Contrasted = متغاير
Contrasting = التغاير
Contrastingly = بشكل متضارب
Contrastive = متباين
Contrasts = المقارنات
Contravene = ناف
Contravened = منافى
Contravener = المخالف
Contravenes = ينافي
Contravening = المنافاة
Contravention = الإنتهاك
Contretemps = اشتباك غير متوقع
Contribute = ساهم
Contributed = مساهم
Contributer = المشارك
Contributers = المشاركون
Contributes = يساهم
Contributing = المساهمة
Contribution = المساهمة
Contributions = المساهمات
Contributive = مساهم
Contributively = بشكل مساهم
Contributor = المساهم
Contributors = المساهمون
Contributory = مساهم
Contrite = تائب
Contritely = تائبا
Contriteness = النّدم
Contrition = الندم
Contrivance = الإختراع
Contrivances = الإختراعات
Contrive = دبّر
Contrived = مدبّر
Contriver = المدير، المخطط
Contrives = يدبّر
Contriving = التدبير
Control = السيطرة
Control-H = سيطرة إتش
ControlBulk = التحكمالجسم
ControlBulkInterrupt = التحكمالجسمالمقاطعة
Controled = المسيطر عليه من قبل
Controllability = قابلية التحكم
Controllable = موجّه
Controllably = على نحو موجّه
Controlled = مسيطر عليه
Controller = جهاز السيطرة
Controllers = أجهزة السيطرة
Controlling = السيطرة على
Controls = السيطرة
Controversial = مثير للجدل
Controversially = جداليا
Controversies = الخلافات
Controversy = الخلاف
Controvert = خالف
Controverted = أثار للجدل
Controvertible = محلّ نزاع
Controverting = النّقاش
Controverts = يخالف
Contumacious = متمرد
Contumaciously = بشكل متمرد
Contumacy = التمرد
Contumely = الإهانة
Contuse = رضّ
Contusion = الكدمة
Contusions = الكدمات
Conundrum = اللغز
Conundrums = الألغاز
Conurbation = المجتمعات المدنيّة
Convalesce = تعاف
Convalesced = متعافى
Convalescence = النقاهة
Convalescent = ناقه
Convalesces = يتعافى
Convalescing = التعافي
Convect = إنقل
Convection = الإنتقال
Convections = الإنتقال
Convector = المسخن
Convene = إجتمع
Convened = مجتمع
Convener = الداعي
Conveners = الدعاة
Convenes = يجتمع
Convenience = الراحة
Conveniences = وسائل الراحة
Convenient = سهل
Conveniently = بشكل ملائم
Convening = الإجتماع
Convent = الدير
Convention = الإتفاقية
Conventional = تقليدي
Conventionalism = تمسّك بالتّقاليد
Conventionality = التّقليديّة
Conventionalize = اجعل تقليديًّا
Conventionalized = جعل تقليديًّا
Conventionalizes = يجعل تقليديًّا
Conventionalizing = جعل تقليديًّا
Conventionally = بشكل تقليدي
Conventionary = العمل بميثاق
Conventioneer = المؤتمر (شخص)
Conventions = الإتفاقيات
Convents = الأديرة
Converge = تلاق
Converged = متلاقى
Convergence = التقارب
Convergences = التقاربات
Convergency = التقارب
Convergent = متقارب
Converges = يتلاقى
Converging = التظافر
Conversant = مطّلع
Conversantly = بشكل مطّلع
Conversation = المحادثة
Conversational = تحادثي
Conversationalist = المتحدث
Conversationally = بشكل تحادثي
Conversations = المحادثات
Converse = الحديث
Conversed = متحدّث
Conversely = بالمقابل
Converser = نقيض
Converses = الأحاديث
Conversing = التحدّث
Conversion = التحويل
Conversions = التحويلات
Convert = المتحول
Converted = تحوّل
Converter = المحول
Converters = المحوّلون
Convertibility = قابلية التحويل
Convertible = قابل للتحويل
Convertibleness = قابليّة التّحويل
Convertibles = السّيّارات المكشوفة
Convertibly = في طريقة متغيّرة
Converting = التحوّل
Converts = المتحوّلون
Convex = محدّب
ConvexConcave = محدبمقعر
Convexities = التحدّبات
Convexity = التحدّب
Convexly = بشكل محدّب
Convexness = التحدّب
Convey = إحمل
Conveyable = محمول
Conveyance = الحمل
Conveyancer = محرّر وثائق نقل الملكيّة
Conveyancers = محرّرون وثائق نقل الملكيّة
Conveyances = الحمل
Conveyancing = إجراءات نقل الملكية
Conveyed = محمول
Conveyer = الحامل
Conveyers = الحاملون
Conveying = الحمل
Conveyor = الناقل
Conveyors = الناقلون
Conveys = يحمل
Convict = المدان
Convicted = مدان
Convicting = الإدانة
Conviction = الإتهام
Convictions = الإتهامات
Convictive = تجريمي
Convicts = المدانون
Convince = إقتنع
Convinced = مقتنع
Convincer = المقنع
Convincers = المقنعون
Convinces = يقتنع
Convincing = الإقتناع
Convincingly = باقناع
Convincingness = الاقناع
Convivial = مؤنس
Convivially = بشكل مؤنس
Convocate = إدع إليه
Convocation = الدعوة
Convocations = الدعوات
Convoke = إدع إليه
Convoked = مدعو إلى
Convokes = يدعو إليه
Convoking = الدعوة إلى
Convolute = ملتوي
Convoluted = ملتوي
Convolutedly = بشكل ملتوي
Convolutely = بشكل ملتوي
Convolutes = يلتوي
Convoluting = الإلتواء
Convolution = الإلتواء
Convolutions = الإلتواءات
Convolve = لفّ
Convolved = ملفوف
Convolves = يلفّ
Convolving = اللفّ
Convoy = القافلة
Convoyed = مواكب
Convoying = المواكبة
Convoys = القوافل
Convulse = تشنّج
Convulsed = متشنّج
Convulses = يتشنّج
Convulsing = التشنّج
Convulsion = التشنّج
Convulsions = التشنّجات
Convulsive = تشنّجي
Convulsively = بشكل تشنّجي
Conway = كونواي
Cony = الأرنب
Coo = إهدل
Cooed = مهدول
Cooing = الهدل
Cook = الطباخ
Cookbook = كتاب الطبخ
Cookbooks = كتب الطبخ
Cooke = كوك
Cooked = مطبوخ
Cooker = الطبّاخ
Cookers = الطباخات
Cookery = فن الطبخ
Cookie = الكوكي
Cookies = الكوكيز
Cooking = الطبخ
Cookmaid = مساعد الطباخ
Cookout = الطهي بالخارج
Cooks = الطبّاخون
Cookshop = مطعم
Cooky = الكعك
Cool = الهدوء :: البرودة :: إهدأ :: لا بارد ولا حار :: جذّاب
Coolant = سائل او غاز يقوم بعمليّة التّبريد
Coolants = المبردة
Cooled = برّد :: هدّأ
Cooler = المبردة
Coolers = المبردات
Coolest = أبرد
Coolheaded = بارد الأعصاب
Coolidge = كوليدج
Coolie = الحمال
Coolies = العمال
Cooling = التبريد
Coolish = بارد
Coolly = بشكل بارد
Coolness = البرودة
Coolnesses = البرودة
Cools = يبرّد
Cooly = بشكل بارد
Coon = الراكون (حيوان)
Coop = القفص
Cooped = محبوس
Cooper = كوبير
Cooperate = تعاون
Cooperated = متعاون
Cooperates = يتعاون
Cooperating = التعاون
Cooperation = التعاون
Cooperations = التعاون
Cooperative = التعاونية
Cooperatively = بتعاون
Cooperativeness = التعاونية
Cooperatives = التعاونيات
Cooperator = المتعاون
Cooperators = المتعاونون
Coopered = صنع البرميل
Coopering = صنع البرميل
Coopers = صانعي البراميل
Cooping = الحبس
Coops = الأعشاش
Coordinate = الإحداثي
Coordinated = منسّق
Coordinately = تنسيقا
Coordinateness = الاحداثية
Coordinates = النظراء
Coordinating = التنسيق
Coordination = التنسيق
Coordinations = التنسيقات
Coordinative = تناسقي
Coordinator = المنسّق
Coordinators = المنسّقون
Coors = كورس
Coot = الطير المائي
Cootie = القملة
Coots = الطير المائي
Cop = الشرطي
Copacetic = ممتاز
Copal = الكوبال
Copartner = الشريك
Copasetic = ممتاز
Cope = العباءة
Coped = متحمّل
Copeland = كوبيلاند
Copenhagen = كوبنهاكن
