Adhort = حثّ :: انصح :: يحذر :: يحض
Adiabatic = ثابت الحرارة :: ذو حرارة غير متغيرة
Adiabatically = بصورة لا يتم معها فقدان او زيادة في الحرارة
Adiaphoristic = يخصّ المسائل الغير متعلقة بالإيمان والعُرف
Adiaphory = اللا مبالاة :: خمول :: عدم أهمية :: لا تحيز
Adieu = الوداع :: وداعاً
Adieus = وداعاً :: الوداع :: مع السلامة
Adige = نهر أديجي الإيطالي
Adight = نظّم :: صفّ :: رتّب
Adina = أدينا
Adino = أدينو
Adios = وداع :: وداعاً :: مع السلامة
Adipic = سمني :: دهني :: مشتق من الدهون
Adipocere = المادة الشمعية الناتجة من إختلاط الشحم مع عضلات الجسم الميت
Adipoma = ورم دهني :: كيس دهني
Adipose = دسم :: يحتوي على شحم الحيوان
Adiposeness = السّمنة :: الدهنية
Adiposity = السّمنة :: الدهنية
Adirondack =  مدينة أدرُندَك
Adirondacks = جبال أدرُندَك السياحية
Adit = مدخل المنجم
Adj = الصّفة
Adjacence = تجاور :: تماس :: متاخمة :: محاذاة
Adjacency = المتاخمة :: التّجاور :: التّماس :: المحاذاة
Adjacent = مجاور :: محاذي :: متاخم
Adjacently = بشكل مجاور :: بشكل محاذي :: بشكل متاخم
Adject = يلحق :: يظم :: يضيف
Adjectival = وصفيّ :: نعتي
Adjectivally = كصفة :: كنعت
Adjective = الصّفة :: النعت
Adjectively = بشكل نعتي :: على شكل صفة
Adjectives = الصّفات :: النعوت
Adjoin = جاور :: حاذى :: يجاور :: يحاذي :: يضم
Adjoined = جاور :: حاذى :: ضمّ
Adjoining = الجوار :: المحاذاة :: الضمّ
Adjoins = يجاور :: يحاذي :: يضم
Adjoint = المساعد :: الملحق :: إضافي
Adjourn = انفضّ :: أرجأ :: يؤجل :: يرجئ
Adjourned = انفضّ :: أجّل :: أرجأ
Adjourning = الانفضاض :: التأجيل :: الإرجاء
Adjournment = إرجاء :: تأجيل :: تأخير :: الإنهاء
Adjourns = ينفضّ :: ينهي :: يؤجّل
Adjudge = يحكم بالقضاء :: يفصل :: ينطق بالحكم
Adjudged = حكم :: نطق بالحكم :: فصل في القضية
Adjudges = ينطق بالحكم :: يحكم
Adjudging = الحكم :: النطق بالحكم :: الفصل
Adjudicate = حكم :: فصل
Adjudicated = حكم :: فصل
Adjudicates = يحكم :: يفصل
Adjudicating = الحكم :: الفصل
Adjudication = التّحكيم :: الفصل :: محاكمة
Adjudications = التّحكيم :: الفصل :: المحاكمة
Adjudicative = قضائيّ :: متعلق بالقضاء
Adjudicator = المحكّم :: القاضي
Adjunct = يُلحق :: يُضيف :: يُساعد
Adjunctive = مُلحق :: إضافي :: مُساعد
Adjunctly = بشكل ملحق :: بشكل مساعد :: بشكل إضافي
Adjuncts = الملاحق :: الإضافات :: المساعدات
Adjure = استحلف :: يستحلف :: يناشد
Adjured = استحلف :: ناشد
Adjures = يستحلف :: يناشد
Adjuring = الاستحلاف :: المناشدة
Adjurnment = الاستحلاف :: المناشدة
Adjust = كيّف :: ضبط :: عدّل :: يكيف :: ينظم
Adjustability = قابلية التعديل :: قابلية التّكيّف :: قابلية التضبيط
Adjustable = قابل للضّبط :: قابل للتعديل :: قابل للتكيف
Adjustably = بشكل قابل للتعديل :: بشكل قابل للضبط
Adjusted = تكيّف :: عدّل :: كيّف :: ضبط
Adjuster = الضّابط :: المعدّل :: المكيّف
Adjusters = الضّبّاط :: المعدّلون :: المكيّفون
Adjusting = التّكيّف :: التّعديل :: التضبيط
Adjustive = تكيّفي :: تعديلي :: ضبطي
Adjustment = التّعديل :: التضبيط
Adjustments = التّعديلات :: التّضبيطات
Adjustor = المكيّف :: المعدّل :: المضبّط
Adjustors = مكيّفون
Adjusts = يتكيّف :: يعدّل :: يضبّط
Adjutant = الضّابط الإداريّ
Adjutants = الضّبّاط الإداريّون
Adkins = أدكينز
Adler = أدلر
Adman = وكيل الإعلانات :: المُعلِن
Administer = أدر :: يدبر :: يدير :: يعاقب
Administered = أدار
Administering = الإدارة
Administerings = الإدارات
Administers = يدير
Administrable = قابل للإدارة
Administrate = تولّ
Administrated = تولّى
Administrates = يتولّى
Administrating = التّولّي
Administration = الإدارة
Administrations = الإدارة
Administrative = إداريّ
Administratively = إداريًّا
Administrator = المدير
Administrators = المديرون
Administratorship = الإدارة
Administratrix = المديرة
Admint = أدمينت
Admirable = جدير بالإعجاب
Admirableness = الجدارة بالإعجاب
Admirably = على نحو جدير بالإعجاب
Admiral = قائد البحريّة :: أمير البحر :: أميرال :: أميرة الفَراش
Admirals = القادة البحريّات
Admiralty = قوّات البحريّة
Admiration = الإعجاب
Admirations = الإعجاب
Admire = أعجبت
Admired = أعجب
Admirer = المعجب
Admirers = المعجبون
Admires = أعجب
Admiring = معجب
Admiringly = بإعجاب
Admissibility = القبول
Admissibillity = القبول
Admissible = مصدّق
Admissibleness = مصداقيّة
Admission = الاعتراف
Admissions = الاعترافات
Admissive = مدخل
Admit = اعترف
Admits = يعترف
Admittance = الدّخول
Admittances = الدّخول
Admitted = اعترف
Admittedly = باعتراف الجميع
Admitting = الاعتراف
Admix = اخلط
Admixed = خلط
Admixes = يخلط
Admixing = الخلط
Admixture = المادّة
Admixtures = الموادّ
Admonish = عاتب
Admonished = عاتب
Admonisher = النّاصح
Admonishes = يعاتب
Admonishing = المعاتبة
Admonishingly = بشكل عتابي
Admonishment = اللّوم
Admonishments = اللّوم
Admonition = العتاب
Admonitions = العتاب
Ado = أدو
Adobe = اللّبنة
Adolescence = المراهقة
Adolescent = المراهق
Adolescently = بشكل مراهق
Adolescents = المراهقون
Adolph = أدولف
Adolphus = أدولفس
Adonis = أدونيس
Adopt = تبنّ
Adoptabilities = قدرات التبنّي
Adoptability = قدرة التبنّي
Adopted = إقامة
Adopter = المتبنّي
Adopters = المتبنّون
Adopting = التّبنّي
Adoption = التّبنّي
Adoptions = التّبنّي
Adoptive = بالتّبنّي
Adoptively = بالتبني
Adopts = يتبنّى
Adorability = الجاذبيّة
Adorable = جذّاب
Adorableness = الجاذبيّة
Adorably = بإعجاب
Adoration = العشق
Adore = اعشق
Adored = عشق
Adorer = أدورر
Adores = يعشق
Adoring = العشق
Adorn = زيّنّ
Adorned = زيّن
Adorner = أدورنر
Adorning = التّزيين
Adornment = الزّينة :: تزيين :: زخرفة :: حِلي
Adornments = الزّينة
Adorns = يزيّن
Adposition = حرف مساعد
Adrenal = الغدّة الكظريّة
Adrenaline = أدرينالاين
Adrenally = كظريا
Adrian = أدرايان
Adriatic = أدرياتيكي
Adrienne = أدرين
Adrift = على غير هدي
Adroit = بارع
Adroitly = ببراعة
Adroitness = البراعة
Adroitnesses = الدهاء
Ads = الإعلانات
Adsorb = كثّف
Adsorbate = كثّف
Adsorbed = كثّف
Adsorbent = مكثّف
Adsorbing = التّكثيف
Adsorbs = يكثّف
Adsorption = الادمصاص
Adsorptive = ادمصاصي
Adsorptively = بادمصاصية
Adulate = تملّق
Adulated = تملّق
Adulates = يتملّق
Adulating = التّملّق
Adulation = التّملّق
Adulations = التّملّق
Adulator = المتملّق
Adulatory = متملّق
Adult = البالغ
Adulterant = الغاشّة
Adulterate = غشّ
Adulterated = غشّ
Adulterates = يغشّ
Adulterating = الغشّ
Adulteration = الغشّ
Adulterator = الغشّاش
Adulterators = الغشّاشون
Adulterer = الزّاني
Adulterers = الزّناة
Adulteress = الزّانية
Adulteresses = الزّناة
Adulteries = الزّنًا
Adulterous = فاسق
Adulterously = متعلّق بالزّنا
Adulterousness = التعلّق بالزّنا
Adultery = الزّنًا
Adulthood = البلوغ
Adultly = بشكل بالغ
Adultness = سن الرشد
Adults = البالغون
Adumbrate = أشر
Adumbrated = أشار
Adumbrates = يشير
Adumbrating = الإشارة
Adumbration = الإشارة
Adumbrative = إشاريّ
Adumbratively = بإشارة
Adumbrativeness = الإشارة
Advance = التّقدّم
Advanced = تقدّم
Advancement = التّقدّم
Advancements = التّقدّم
Advancer = المتقدّم
Advancers = المتقدّمون
Advances = التّقدّم
Advancing = التّقدّم
Advantage = الميزة
Advantaged = مفاد
Advantageous = مفيد
Advantageously = على نحو مفيد
Advantageousness = الفائدة
Advantages = الميزات
Advantaging = الإفادة
Advantagious = إفاديّ
Advent = الحلول
Adventist = السبتي -مجيئي
Adventists = السبتي -مجيئي
Adventitious = عرضيّ
Adventitiously = على نحو عرضيّ
Adventitiousness = العرضية
Adventive = الغير بلديّ
Adventively = بشكل غير بلدي
Adventure = المغامرة
Adventured = غامر
Adventurer = المغامر
Adventurers = المغامرون
Adventures = المغامرات
Adventuresome = مغامر
Adventuresomely = بشكل مقدام
Adventuress = المغامرة
Adventuring = المغامرة
Adventurous = مغامر
Adventurously = بمخاطرة
Adventurousness = المغامرة
Adverb = الظّرف
Adverbial = الظّرف
Adverbially = كظرف
Adverbs = الظّروف
Adversaries = الأعداء
Adversary = العدوّ
Adverse = معادي
Adversed = عادى
Adversely = على نحو معادٍ
Adverseness = الخصومة
Adverses = يخاصم
Adversing = مخاصمة
Adversities = المشكلات
Adversity = المحنة
Advert = الإعلان
Adverted = مشار إلى
Advertence = الإهتمام
Advertencies = إهتمامات
Advertency = الإهتمام
Advertent = منتبه
