Distanced = مبعد
Distances = المسافات
Distancing = الإبعاد
Distant = بعيد
Distantly = بشكل بعيد
Distantness = البعد
Distaste = الكره
Distasteful = مقيت
Distastefully = بشكل مقيت
Distastefulness = رداءه الطعم
Distastes = الكره
Distemper = سل الكلاب
Distempered = مشوّش
Distempers = يشوّش
Distend = إنفخ
Distended = منفوخ
Distending = النفخ
Distends = ينفخ
Distensible = قابل الانتفاخ
Distension = الإنتفاخ
Distensions = الإنتفاخات
Distich = بندان لنفس النّوع
Distichs = بندان لنفس النّوع
Distill = قطّر
Distillate = المادّة المقطّرة
Distillates = المواد المقطّرة
Distillation = التقطير
Distillations = التقطير
Distilled = مقطّر
Distiller = المقطّر
Distilleries = معامل التقطير
Distillers = المقطّر
Distillery = معمل التقطير
Distilling = التقطير
Distills = يقطّر
Distils = يقطّر
Distinct = متميّز
Distinction = الفرق
Distinctions = الفروق
Distinctive = مميّز
Distinctively = بشكل مميّز
Distinctiveness = التمييز
Distinctly = بوضوح
Distinctness = التباين
Distinguish = ميّز
Distinguishable = متميّز
Distinguishably = على نحو مميّز
Distinguished = بارز
Distinguisher = المميز
Distinguishes = يميّز
Distinguishing = التمييز
Distoma = ديستوما (دودة)
Distort = حرّف
Distortable = قابل للتشويه
Distorted = مشوّه
Distorter = المشوه
Distorting = التحريف
Distortion = التشويه
Distortions = التشويهات
Distorts = يحرّف
Distract = إصرف إنتباهه
Distracted = صرف إنتباهه
Distractedly = بتحير
Distractibility = التّشتّت
Distractible = قابل للتشتت
Distracting = صرف إنتباه
Distractingly = بطريقة تصرف الإنتباه
Distraction = صرف الإنتباه
Distractions = حالات صرف الإنتباه
Distractive = إلهائي
Distracts = يصرف إنتباهه
Distrain = إحجز
Distrainable = قابل للحجز
Distrained = محجوز
Distrainee = المتدرب
Distrainees = المتدربون
Distraining = الحجز
Distrainor = الحاجز
Distrainors = الحاجزون
Distrains = يحجز
Distraint = الحجز
Distraught = مذهول
Distraughtly = بشكل مذهول
Distress = الضيق
Distressed = مكتئب
Distresses = الكآبة
Distressful = محزن
Distressfully = بشكل مؤلم
Distressfulness = الحزن
Distressing = الإحزان
Distressingly = بشكل مؤلم
Distributable = قابل للتوزيع
Distribute = وزّع
Distributed = موزّع
Distributer = الموزّع
Distributes = يوزّع
Distributing = التوزيع
Distribution = التوزيع
Distributional = توزيعي
Distributions = التوزيعات
Distributive = توزيعي
Distributively = بشكل توزيعي
Distributiveness = التسويقيّة
Distributivity = التسويقيّة
Distributor = الموزّع
Distributors = الموزّعون
Distributorship = مكان البيع بالتجزأة
District = المنطقة
Districted = قسّم
Districting = التقسيم
Districts = المناطق
Distroy = ديستروي
Distrust = الإرتياب
Distrusted = مشكوك في
Distrustful = مرتاب
Distrustfully = بارتياب
Distrustfulness = انعدام الثقة
Distrusting = الشكّ في
Distrustingly = بريبة
Distrusts = الإرتياب
Disturb = أزعج
Disturbance = الإضطراب
Disturbances = الإضطرابات
Disturbed = قلق
Disturber = المزعج
Disturbing = الإزعاج
Disturbingly = بشكل مقلق
Disturbs = يزعج
Disulfide = مركب يحتوي على ذرّتين من الكبريت
Disulphide = مركب يحتوي على ذرّتين من الكبريت
Disunion = الإنشقاق
Disunited = مفصول
Disunites = يفصل
Disunity = الإنشقاق
Disuse = الترك
Disused = غير مستعمل
Disvalues = يحطّ من قيمة
Disyllable = العبارة ذات المقطعين
Ditch = الخندق
Ditched = متخندق
Ditcher = الحفار
Ditches = الخنادق
Ditching = التخندق
Dither = التردّد
Dithered = مرتبك
Ditherer = المتردّد
Dithering = الإرتباك
Ditties = الأناشيد
Ditto = كذلك
Dittos = الأشياء نفسها
Ditty = الإنشودة
Ditzel = ديزيل
Diuretic = مدرّر
Diurnal = نهاري
Diurnally = بشكل نهاري
Diva = المغنية
Divalent = ثنائي التّكافؤ
Divan = الأريكة
Divans = الأرائك
Divas = المغنّيات
Dive = الغطس
Dived = مغيص
Diver = الغوّاص
Diverge = تباعد
Diverged = متباعد
Divergence = الإنحراف
Divergences = الإنحرافات
Divergency = الإنحراف
Divergent = متباعد
Divergently = بشكل متباعد
Diverges = يتباعد
Diverging = التباعد
Divers = الغوّاصون
Diverse = متنوّع
Diversely = بتنوع
Diverseness = الاختلاف
Diversification = التنويع
Diversified = منوّع
Diversifier = المسبب للاختلاف
Diversifies = ينوّع
Diversify = نوّع
Diversifying = التنويع
Diversion = الإنحراف
Diversionary = تضليلي
Diversions = الإنحرافات
Diversities = التنويع
Diversity = التنويع
Divert = حوّل
Diverted = محوّل
Divertimento = قطعة موسيقية
Diverting = التحويل
Diverts = يحوّل
Dives = الغطس
Divest = جرّد
Divested = مجرّد
Divesting = التجريد
Divestiture = التجريد
Divestment = البيع
Divests = يجرّد
Divide = التقسيم
DivideComment = ملاحظة تقسيم
Divided = منقسم
Dividend = الحصة
Dividends = الحصص
Divider = المقسم
Dividers = المقسّمات
Divides = الإنقسامات
Dividing = التقسيم
Divination = التكهن
Divine = القسّ
Divined = متكهّن
Divinely = إلهيا
Divineness = التّميّز الأعلى
Diviner = قدسي
Divines = القسسة
Diving = الغوص
Divining = التكهّن
Divinities = الإلهيات
Divinity = اللاهوت
Divisibility = قابليّة القسمة
Divisible = قابل للقسمة
Divisibly = بشكل تقسيمي
Division = القسم
Divisional = تقسيمي
Divisions = الإنقسامات
Divisive = خلافي
Divisively = بشكل خلافي
Divisiveness = الشّقاق
Divisor = المقسوم
Divisors = المقسومات
Divorce = الطلاق
Divorced = مطلّق
Divorcee = المطلّق
Divorcees = المطلّقون
Divorces = الطلاقات
Divorcing = الطلاق
Divulgation = الإفشاء
Divulge = أبح
Divulged = مباح
Divulgement = الإفشاء
Divulgence = الإباحة
Divulges = يبيح
Divulging = الإباحة
Divvied = قسّم
Divvies = عوائد الأسهم
Divvying = التّقسيم
Dixie = الغلاية
Dixiecrats = ديكسيكراتس (حزب سابق في الولايات المتحدة)
Dixieland = ديكسيلاند - ال11 ولاية الجنوبيّة التي انسحبت من الولايات المتّحدة في 1861
Dixon = ديكسن
Dizzied = أصاب بالدّوار
Dizzier = أكثر دوخة
Dizzies = الدوار
Dizziest = أكثر دوخة
Dizzily = بدوخة
Dizziness = الدوخة
Dizzinesses = الدوخة
Dizzy = مشوش
Dizzying = إصابة بالدّوار
Dizzyingly = على نحو مربك
Djibouti = جيبوتي
DL = تنزيل
DMA = ديامأيه
Dmitri = ديميتري
DNA = الدي.إن.إيه (الحامض النووي)
Dnieper = دنيبير
DNS = دياناس
Do = يعمل
Do-nothing = عاطل
Do-statement = يعمل بيان
Doable = ممكن
Dob = دوب
Dobbin = دوبين
Dobbs = دوبس
Doberman = دوبيرمان
Dobson = دوبسون
Doc = الدّكتور
Docile = سلس
Docilely = بشكل سلس
Dociler = سلس
Docilest = سلس
Docility = السلاسة
Dock = حوض السفن
Dockable = قابل للإرساء
Dockage = الأجرة
Docked = مرسى
Docker = عامل الميناء
Docket = القائمة
Docketed = ملخّص
Docketing = التلخيص
Dockets = القوائم
Docking = الإرساء
Docks = أحواض السفن
Dockside = الرّصيف
Dockyard = المسفن
Docs = دوس
Doctor = الطبيب
Doctoral = دكتوراه
Doctorate = الدكتوراه
Doctorates = الدكتوراه
