Foreshortened = مقصّر
Foreshortening = التقصير
Foreshortens = يقصّر
Foresight = البصيرة
Foresighted = واعي
Foresightedly = بشكل واعي
Foresightedness = الرؤية المستقبلية
Foresights = البصائر
Foreskin = القلفة
Foreskins = القلفات
Forest = الغابة
Forestall = أحبط
Forestalled = محبط
Forestaller = المؤخِّر
Forestalling = الإحباط
Forestallment = التأخير
Forestalls = يحبط
Forestay = الحبل الأمامي
Forested = مشجّر
Forester = حارس الغابة
Foresters = حراس الغابات
Forestry = علم الغابات
Forests = الغابات
Foretaste = الفكرة السابقة
Foretastes = الأفكار السابقة
Foretell = تنبّأ
Foreteller = العرّاف
Foretelling = التنبّأ
Foretells = يتنبّأ
Forethought = التدبر
Forethoughts = التدبر
Foretime = الماضي
Foretoken = إنذار
Foretold = تنبّأ
Foretop = شعر الهامة
Forever = إلى الأبد
Foreverness = الأبدية، الخلود
Forewarn = حذّر
Forewarned = محذّر
Forewarning = التحذير
Forewarns = يحذّر
Forewoman = رئيسة العمال
Forewomen = رئيسات العمال
Foreword = المقدمة
Forewords = المقدمات
Foreyard = الصّاري الأكثر انخفاضاً المساند للشراع
Forfeit = الغرامة
Forfeitable = قابل للإستسلام
Forfeited = خاسر
Forfeiter = المستسلم
Forfeiters = المستسلمون
Forfeiting = الخسارة
Forfeits = الغرامات
Forfeiture = الغرامة
Forfeitures = الغرامات
Forfend = إحم
Forfended = محمي
Forfending = الحماية
Forfends = يحمي
Forficate = يفرّع
Forgather = إجتمع
Forgathered = مجتمع
Forgathering = الإجتماع
Forgathers = يجتمع
Forgave = غفر له
Forge = كور الحداد
Forgeable = قابل للتزوير
Forged = مزوّر
Forger = المزور
Forgeries = التزييف
Forgers = المزوّرون
Forgery = التزييف
Forges = دكاكين الحدادة
Forget = إنس
Forgetful = كثير النسيان
Forgetfully = بشكل كثير النسيان
Forgetfulness = النسيان
Forgetfulnesses = النسيان
Forgetive = مخترع
Forgets = ينسي
Forgettable = معرض للنسيان
Forgetting = النسيان
Forging = الصياغة
Forgivable = قابل للعفو
Forgivably = بعفو
Forgive = إغفر له
Forgiven = مغفور لـ
Forgiveness = المغفرة
Forgivenesses = المغفرة
Forgiver = المسامح
Forgives = يغفر له
Forgiving = الغفران
Forgivingly = بشكل متسامح
Forgivingness = المغفرة
Forgo = تخلّ عنه
Forgoer = الممتنع
Forgoes = يتخلّى عنه
Forgoing = التخلّي عن
Forgone = تخلّى عنه
Forgot = نسى
Forgotten = منسي
Forisfamiliation = الحرمان من الإرث
Forjudge = التسرّع بالحكم
Fork = الشوكة
Fork-lift = الرافعة
Forked = متشعّب
Forker = المفرّق
Forking = التفرّع
Forklift = الرافعة
Forks = فوركس
Forlorn = يائس
Forlornly = بشكل يائس
Forlornness = حزن الفراق
Form = الشكل
Formability = القابلية للتشكيل
Formal = الثوب
Formaldehyde = فورمالديهايد
Formalin = الفورمالين
Formalins = الفورمالين
Formalise = شكّل
Formalised = مشكّل
Formalises = يشكّل
Formalising = التشكيل
Formalism = الشكلية
Formalisms = الشكلية
Formalist = الشكلي
Formalistic = شكلي
Formalisticly = بشكل شكلي
Formalists = الشكليون
Formalities = الشكليات
Formality = الشكلية
Formalization = التشكيل
Formalizations = التشكيلات
Formalize = شكّل
Formalized = مشكّل
Formalizer = الصّائغ، المعبّر
Formalizes = يشكّل
Formalizing = التشكيل
Formally = رسميا
Formalness = الرسمية
Formals = الثياب
Formant = صفة صوت الكلام
Formants = صفات أصوات الكلام
Format = الصيغة
Formate = فورميت
Formates = فورماتيز
Formation = التشكيل
Formations = التشكيلات
Formative = مشكّل
Formatively = بشكل مشكّل
Formats = الصيغ
Formatted = مهيّأ
Formatting = التهيئة
Formed = مشكّل
Former = الأول
Formerly = سابقا
Formers = المشكّلون
Formes = فورمز - برمجيّة لتأليف الموسيقى
Formic = نملي
Formica = الفورميكا
Formicary = بيت النّمل
Formicate = يمشي مثل النمل
Formication = مشي النمل
Formidable = هائل
Formidableness = الهول
Formidablenesses = الهول
Formidably = بشكل لا يقهر
Forming = التشكيل
Formless = بلا شكل
Formlessly = بشكل بلا شكل
Formlessness = بلا شكل محدد
Formosa = فورموسا
Formosan = فورموسان - متعلّق بتايوان
Forms = الأشكال
Formula = الصيغة
Formulae = الصيغ
Formulaic = معادليْ
Formularies = كتاب السّوابق
Formulary = صيغي
Formulas = الصيغ
Formulate = صغ
Formulated = معدّ
Formulates = يصوغ
Formulating = الصياغة
Formulation = الصياغة
Formulations = الصياغات
Formulator = المعادل
Formulators = المعادلون
Fornent = قريب من
Fornicate = إزن
Fornication = الزنا
Fornicator = الزاني
Forrader = متّجه إلى الأمام
Forrest = فورست
Forsake = إترك
Forsaken = متروك
Forsakes = يترك
Forsaking = الترك
Forsook = ترك
Forsooth = حقا
Forswear = تعهّد بنبذه
Forswearing = تعهّد بنبذ
Forswears = يتعهّد بنبذه
Forswore = تعهّد بنبذه
Forsworn = تعهّد بنبذه
Forsythe = فورسيذي
Fort = الحصن
Forte = البراعة
Fortes = البراعات
Fortescue = فورتسكو
Forth = فصاعدا
Forthcoming = قادم
Forthright = مباشر
Forthrightly = بصراحة
Forthrightness = الوضوح
Forthwith = حالا
Fortier = فورتير
Forties = الأربعينات
Fortieth = أربعون
Fortieths = جزء من أربعين
Fortifiable = قابل للتحصين
Fortification = التحصين
Fortifications = التحصينات
Fortified = محصّن
Fortifier = المحصّن
Fortifiers = المحصّنات
Fortifies = يحصّن
Fortify = حصّن
Fortifying = التحصين
Fortin = قلعة صغيرة
Fortis = الشّديد
Fortitude = الثبات
Fortnight = الإسبوعان
Fortnightly = مرة كل إسبوعين
Fortran = فورتران
Fortress = القلعة
Fortresses = القلاع
Forts = الحصون
Fortuities = الصدف
Fortuitous = عرضي
Fortuitously = مصادفة
Fortuitousness = الإتفاق
Fortuity = الصدفة
Fortunate = محظوظ
Fortunately = لحسن الحظ
Fortunateness = حسن الحظ
Fortunates = المحظوظين
Fortune = الثروة
Fortuned = محظوظ
Fortunes = الثروات
Fortuneteller = قارئ البخت
Fortunetellers = قارئو البخت
Fortunetelling = قراءة البخت
Fortuning = الحظ
Forty = أربعون
Forum = المنتدى
Forums = المنتديات
Forward = يعزز :: أمامي :: توّاق :: أرسل :: الأمام
Forward-bias = التحيّز الأمامي
Forward-space = الفضاء الأمامي
Forwarded = مرسل
Forwarder = الشاحن
Forwarders = الشاحنون
Forwarding = الشحن
Forwardly = بشكل إلى الأمام
Forwardness = قُدُماً
Forwards = المهاجمون
Forwent = إمتنع عنه
Foss = فوس
Fosse = الخندق
Fosses = الخنادق
Fossick = نقّب عنه
Fossicked = منقّب عن
Fossicking = التنقيب عن
Fossicks = ينقّب عنه
Fossil = متحجّر
Fossiliferous = متحجّر
Fossilization = التحجر
Fossilizations = التحجر
Fossilize = حجّر
Fossilized = محجّر
Fossilizes = يحجّر
Fossilizing = التحجير
Fossils = المتحجرات
Fossorial = أُحفوري
Foster = تبنّ
Fostered = تبنّى
Fosterer = المربِّي، الراعي
Fostering = التبنّي
Fosterling = طفل التبنّي
Fosters = يتبنّى
Fought = قوتل
Foul = الخطأ
Foulard = الفولار
Foulards = الفولار
Fouled = مفسد
Fouler = أكثر قذارة
Foulest = أكثر قذارة
Fouling = الإفساد
Foully = بشكل كريه
